type, operation, timeCostBeforeOperation(Second), recvedWhenOperation(KB), sniffedPacketNum, sniffedPayload(KB), recvedAfterOperation
100mbit_0ms, cancel, 11,39305,30097,42552,3247
100mbit_0ms, cancel, 17,57359,41634,58867,1508
100mbit_0ms, cancel, 18,46426,35204,49770,3344
100mbit_0ms, cancel, 19,58087,43281,61193,3106
100mbit_0ms, cancel, 11,37361,28749,40646,3285
100mbit_0ms, cancel, 17,57682,43257,61160,3478
100mbit_0ms, cancel, 12,37960,29040,41058,3098
100mbit_0ms, cancel, 15,50424,38100,53869,3445
100mbit_0ms, cancel, 19,64221,47805,67591,3370
100mbit_0ms, cancel, 18,57158,42983,60771,3613
100mbit_0ms, cancel, 13,41200,31307,44261,3061
100mbit_0ms, cancel, 13,44642,33412,47238,2596
100mbit_0ms, cancel, 13,44475,33818,47814,3339
100mbit_0ms, cancel, 13,43961,33450,47290,3329
100mbit_0ms, cancel, 13,45270,34465,48728,3458
100mbit_100ms, cancel, 13,18604,14544,20561,1957
100mbit_100ms, cancel, 13,35583,27042,38232,2649
100mbit_100ms, cancel, 13,28751,21383,30229,1478
100mbit_100ms, cancel, 13,37006,28488,40277,3271
100mbit_100ms, cancel, 13,41433,31879,45067,3634
100mbit_100ms, cancel, 13,43015,32790,46356,3341
100mbit_100ms, cancel, 13,27309,21726,30716,3407
100mbit_100ms, cancel, 16,42755,32668,46187,3432
100mbit_100ms, cancel, 14,46485,35223,49799,3314
100mbit_100ms, cancel, 11,35440,27479,38849,3409
100mbit_100ms, cancel, 17,7849,6506,9195,1346
100mbit_100ms, cancel, 16,44411,32998,46656,2245
100mbit_100ms, cancel, 17,51799,353605,500000,448201
100mbit_100ms, cancel, 11,31325,24288,34337,3012
100mbit_100ms, cancel, 17,24614,19778,27958,3344
100mbit_250ms, cancel, 19,52601,39576,55957,3356
100mbit_250ms, cancel, 19,16645,13333,18847,2202
100mbit_250ms, cancel, 18,50638,38198,54008,3370
100mbit_250ms, cancel, 13,34506,26843,37952,3446
100mbit_250ms, cancel, 13,32593,25413,35929,3336
100mbit_250ms, cancel, 20,56509,42691,60361,3852
100mbit_250ms, cancel, 16,12521,11213,15848,3327
100mbit_250ms, cancel, 11,26684,21306,30122,3438
100mbit_250ms, cancel, 17,29561,22929,32418,2857
100mbit_250ms, cancel, 12,29699,23470,33180,3481
100mbit_250ms, cancel, 15,39700,30515,43143,3443
100mbit_250ms, cancel, 16,40009,30662,43350,3341
100mbit_250ms, cancel, 13,13518,10989,15531,2013
100mbit_250ms, cancel, 20,53596,40307,56990,3394
100mbit_250ms, cancel, 19,52157,39319,55592,3435
100mbit_500ms, cancel, 15,2747,2365,3340,593
100mbit_500ms, cancel, 20,4022,3264,4608,586
100mbit_500ms, cancel, 13,2378,2118,2988,610
100mbit_500ms, cancel, 11,1987,1943,2741,754
100mbit_500ms, cancel, 18,3386,2842,4014,628
100mbit_500ms, cancel, 17,3249,2812,3969,720
100mbit_500ms, cancel, 16,2994,2607,3680,686
100mbit_500ms, cancel, 15,2754,2410,3400,646
100mbit_500ms, cancel, 20,3892,3263,4607,715
100mbit_500ms, cancel, 17,3126,2682,3785,659
100mbit_500ms, cancel, 16,2997,2613,3688,691
100mbit_500ms, cancel, 15,2748,2408,3397,649
100mbit_500ms, cancel, 20,3891,3194,4510,619
100mbit_500ms, cancel, 13,2370,2188,3088,718
100mbit_500ms, cancel, 14,2491,2178,3074,583
100mbit_50ms, cancel, 13,37007,28287,39990,2983
100mbit_50ms, cancel, 20,51641,38894,54992,3351
100mbit_50ms, cancel, 18,6181,5421,7659,1478
100mbit_50ms, cancel, 15,4053,3537,4995,942
100mbit_50ms, cancel, 19,40306,29882,42249,1943
100mbit_50ms, cancel, 11,32543,25392,35896,3353
100mbit_50ms, cancel, 17,27221,20807,29415,2194
100mbit_50ms, cancel, 12,3951,3437,4854,903
100mbit_50ms, cancel, 18,50679,38071,53828,3149
100mbit_50ms, cancel, 20,52860,38975,55107,2247
100mbit_50ms, cancel, 19,29833,22662,32039,2206
100mbit_50ms, cancel, 14,2113,2345,3309,1196
100mbit_50ms, cancel, 15,29662,22440,31723,2061
100mbit_50ms, cancel, 12,35571,26700,37749,2178
100mbit_50ms, cancel, 15,47810,36603,51749,3939
10mbit_0ms, cancel, 18,20808,15322,21661,853
10mbit_0ms, cancel, 13,14858,11060,15634,776
10mbit_0ms, cancel, 16,7552,6196,8755,1203
10mbit_0ms, cancel, 19,20893,15389,21755,862
10mbit_0ms, cancel, 11,11607,9000,12721,1114
10mbit_0ms, cancel, 17,18566,14086,19913,1347
10mbit_0ms, cancel, 12,1920,2135,3013,1093
10mbit_0ms, cancel, 19,20714,15217,21511,797
10mbit_0ms, cancel, 11,12823,9622,13600,777
10mbit_0ms, cancel, 13,13082,9945,14057,975
10mbit_0ms, cancel, 13,10745,8535,12063,1318
10mbit_0ms, cancel, 13,15073,11331,16017,944
10mbit_0ms, cancel, 13,15131,11356,16053,922
10mbit_0ms, cancel, 13,13356,10261,14502,1146
10mbit_0ms, cancel, 13,12357,9440,13343,986
10mbit_100ms, cancel, 17,19362,16053,22695,3333
10mbit_100ms, cancel, 19,13905,11487,16237,2332
10mbit_100ms, cancel, 18,20502,16878,23860,3358
10mbit_100ms, cancel, 17,19382,16086,22740,3358
10mbit_100ms, cancel, 19,21702,17713,25042,3340
10mbit_100ms, cancel, 15,16947,14106,19941,2994
10mbit_100ms, cancel, 13,14561,12095,17096,2535
10mbit_100ms, cancel, 20,22787,18483,26131,3344
10mbit_100ms, cancel, 13,14633,12382,17502,2869
10mbit_100ms, cancel, 17,19384,16074,22724,3340
10mbit_100ms, cancel, 19,21592,17649,24950,3358
10mbit_100ms, cancel, 15,17034,14410,20371,3337
10mbit_100ms, cancel, 13,12564,9869,13949,1385
10mbit_100ms, cancel, 11,11633,10284,14534,2901
10mbit_100ms, cancel, 11,12253,10197,14412,2159
10mbit_250ms, cancel, 11,10432,8922,12611,2179
10mbit_250ms, cancel, 14,13387,11290,15957,2570
10mbit_250ms, cancel, 15,14451,12178,17215,2764
10mbit_250ms, cancel, 13,13394,11544,16319,2925
10mbit_250ms, cancel, 17,17716,14900,21062,3346
10mbit_250ms, cancel, 19,19434,16140,22815,3381
10mbit_250ms, cancel, 15,14350,12027,17000,2650
10mbit_250ms, cancel, 13,13058,11323,16005,2947
10mbit_250ms, cancel, 17,16784,14050,19862,3078
10mbit_250ms, cancel, 19,20332,16595,23459,3127
10mbit_250ms, cancel, 15,14121,11886,16800,2679
10mbit_250ms, cancel, 16,15801,13132,18563,2762
10mbit_250ms, cancel, 11,10540,9712,13728,3188
10mbit_250ms, cancel, 11,10938,9389,13271,2333
10mbit_250ms, cancel, 14,13419,11262,15920,2501
10mbit_500ms, cancel, 11,1982,1867,2636,654
10mbit_500ms, cancel, 18,3510,2931,4138,628
10mbit_500ms, cancel, 14,2615,2359,3329,714
10mbit_500ms, cancel, 19,3630,3080,4349,719
10mbit_500ms, cancel, 12,2112,1928,2721,609
10mbit_500ms, cancel, 16,2970,2528,3569,599
10mbit_500ms, cancel, 18,3414,2856,4033,619
10mbit_500ms, cancel, 11,1980,1830,2580,600
10mbit_500ms, cancel, 18,3377,2835,4004,627
10mbit_500ms, cancel, 14,2624,2313,3264,640
10mbit_500ms, cancel, 19,3628,3088,4361,733
10mbit_500ms, cancel, 15,2741,2385,3366,625
10mbit_500ms, cancel, 17,3161,2740,3869,708
10mbit_500ms, cancel, 19,3492,2917,4118,626
10mbit_500ms, cancel, 12,2222,2010,2835,613
10mbit_50ms, cancel, 11,11997,10038,14189,2192
10mbit_50ms, cancel, 14,15545,11815,16700,1155
10mbit_50ms, cancel, 11,12508,10396,14695,2187
10mbit_50ms, cancel, 14,15958,13116,18541,2583
10mbit_50ms, cancel, 18,20178,16256,22979,2801
10mbit_50ms, cancel, 17,19530,15800,22335,2805
10mbit_50ms, cancel, 12,6350,5548,7839,1489
10mbit_50ms, cancel, 12,13520,11386,16093,2573
10mbit_50ms, cancel, 12,13771,11566,16350,2579
10mbit_50ms, cancel, 12,13706,11565,16347,2641
10mbit_50ms, cancel, 19,21904,17870,25263,3359
10mbit_50ms, cancel, 18,15496,12729,17993,2497
10mbit_50ms, cancel, 16,17767,14702,20784,3017
10mbit_50ms, cancel, 14,15830,13068,18473,2643
10mbit_50ms, cancel, 15,16827,14325,20249,3422
50mbit_0ms, cancel, 13,46005,35157,49709,3704
50mbit_0ms, cancel, 13,43761,32165,45478,1717
50mbit_0ms, cancel, 13,45252,34370,48591,3339
50mbit_0ms, cancel, 13,45564,34011,48086,2522
50mbit_0ms, cancel, 16,54315,40698,57539,3224
50mbit_0ms, cancel, 17,60970,45489,64313,3343
50mbit_0ms, cancel, 12,22678,17380,24569,1891
50mbit_0ms, cancel, 15,47141,35200,49766,2625
50mbit_0ms, cancel, 19,41535,31224,44146,2611
50mbit_0ms, cancel, 11,39227,29990,42400,3173
50mbit_0ms, cancel, 17,59047,44131,62395,3348
50mbit_0ms, cancel, 15,32364,24734,34969,2605
50mbit_0ms, cancel, 19,28104,20788,29387,1283
50mbit_0ms, cancel, 14,47556,34910,49358,1802
50mbit_0ms, cancel, 11,39155,29781,42103,2948
50mbit_100ms, cancel, 14,28343,353609,500000,471657
50mbit_100ms, cancel, 14,8486,6803,9613,1127
50mbit_100ms, cancel, 11,36222,28074,39688,3466
50mbit_100ms, cancel, 17,52355,39417,55730,3375
50mbit_100ms, cancel, 15,41910,31668,44773,2863
50mbit_100ms, cancel, 19,65082,48442,68491,3409
50mbit_100ms, cancel, 11,34262,26581,37581,3319
50mbit_100ms, cancel, 17,58414,43681,61760,3346
50mbit_100ms, cancel, 12,13018,11567,16350,3332
50mbit_100ms, cancel, 18,45310,34209,48366,3056
50mbit_100ms, cancel, 13,43429,33110,46811,3382
50mbit_100ms, cancel, 13,38972,29654,41927,2955
50mbit_100ms, cancel, 13,23590,18676,26401,2811
50mbit_100ms, cancel, 12,4313,3910,5523,1210
50mbit_100ms, cancel, 19,49449,37331,52782,3333
50mbit_250ms, cancel, 13,30461,23984,33909,3448
50mbit_250ms, cancel, 16,8570,6941,9809,1239
50mbit_250ms, cancel, 17,33122,25771,36435,3313
50mbit_250ms, cancel, 12,24365,19505,27574,3209
50mbit_250ms, cancel, 12,16975,13680,19337,2362
50mbit_250ms, cancel, 15,26875,21159,29911,3036
50mbit_250ms, cancel, 16,10248,9433,13332,3084
50mbit_250ms, cancel, 16,39980,30727,43443,3463
50mbit_250ms, cancel, 17,28775,22393,31658,2883
50mbit_250ms, cancel, 15,33406,26003,36765,3359
50mbit_250ms, cancel, 16,27636,21764,30769,3133
50mbit_250ms, cancel, 14,21209,16706,23615,2406
50mbit_250ms, cancel, 11,11686,9505,13433,1747
50mbit_250ms, cancel, 17,44420,34020,48098,3678
50mbit_250ms, cancel, 12,30735,24104,34079,3344
50mbit_500ms, cancel, 13,2245,2034,2871,626
50mbit_500ms, cancel, 18,3384,2906,4101,717
50mbit_500ms, cancel, 11,1864,1784,2515,651
50mbit_500ms, cancel, 15,2370,2124,2996,626
50mbit_500ms, cancel, 14,2206,2045,2885,679
50mbit_50ms, cancel, 13,33590,25500,36053,2463
50mbit_50ms, cancel, 13,35529,27657,39100,3571
50mbit_50ms, cancel, 20,50819,38289,54137,3318
50mbit_50ms, cancel, 16,40274,30014,42434,2160
50mbit_50ms, cancel, 17,53747,40337,57032,3285
50mbit_50ms, cancel, 15,39922,29856,42212,2290
50mbit_50ms, cancel, 12,21030,16587,23448,2418
50mbit_50ms, cancel, 16,27449,20784,29384,1935
50mbit_50ms, cancel, 17,23208,18566,26247,3039
50mbit_50ms, cancel, 13,15046,11678,16505,1459
50mbit_50ms, cancel, 20,33109,25287,35751,2642
50mbit_50ms, cancel, 14,23617,18516,26174,2557
50mbit_50ms, cancel, 18,29375,22376,31636,2261
50mbit_50ms, cancel, 13,30565,23343,33003,2438
50mbit_50ms, cancel, 20,55083,41461,58620,3537
5mbit_0ms, cancel, 13,7580,5852,8270,690
5mbit_0ms, cancel, 13,7557,5820,8223,666
5mbit_0ms, cancel, 13,7594,5856,8275,681
5mbit_0ms, cancel, 20,11715,8783,12413,698
5mbit_0ms, cancel, 19,11098,8347,11794,696
5mbit_0ms, cancel, 11,6437,5030,7108,671
5mbit_0ms, cancel, 17,9923,7490,10585,662
5mbit_0ms, cancel, 19,11128,8355,11808,680
5mbit_0ms, cancel, 11,6420,5028,7105,685
5mbit_0ms, cancel, 17,9937,7475,10563,626
5mbit_0ms, cancel, 12,7031,5440,7687,656
5mbit_0ms, cancel, 12,6972,5456,7709,737
5mbit_0ms, cancel, 19,11126,8357,11811,685
5mbit_0ms, cancel, 11,6403,5036,7116,713
5mbit_0ms, cancel, 17,9937,7535,10648,711
5mbit_100ms, cancel, 19,10943,9208,13016,2073
5mbit_100ms, cancel, 12,6012,5020,7093,1081
5mbit_100ms, cancel, 16,9070,7948,11234,2164
5mbit_100ms, cancel, 18,10298,8704,12302,2004
5mbit_100ms, cancel, 14,7925,7036,9942,2017
5mbit_100ms, cancel, 15,8533,7473,10560,2027
5mbit_100ms, cancel, 17,9605,8285,11708,2103
5mbit_100ms, cancel, 19,10931,9238,13058,2127
5mbit_100ms, cancel, 12,6833,5950,8408,1575
5mbit_100ms, cancel, 16,9164,8041,11361,2197
5mbit_100ms, cancel, 18,7416,5926,8372,956
5mbit_100ms, cancel, 14,7895,6893,9741,1846
5mbit_100ms, cancel, 15,8595,7519,10626,2031
5mbit_100ms, cancel, 17,9755,8479,11984,2229
5mbit_100ms, cancel, 13,7334,6376,9011,1677
5mbit_250ms, cancel, 14,7156,6298,8901,1745
5mbit_250ms, cancel, 12,5962,5259,7430,1468
5mbit_250ms, cancel, 16,8441,353595,500000,491559
5mbit_250ms, cancel, 18,9350,8071,11405,2055
5mbit_250ms, cancel, 14,7067,6249,8830,1763
5mbit_250ms, cancel, 12,6290,5738,8109,1819
5mbit_250ms, cancel, 16,8725,7626,10778,2053
5mbit_250ms, cancel, 18,9547,8230,11631,2084
5mbit_250ms, cancel, 14,7218,6327,8941,1723
5mbit_250ms, cancel, 12,5859,5160,7291,1432
5mbit_250ms, cancel, 19,10405,8810,12450,2045
5mbit_250ms, cancel, 19,10271,8772,12396,2125
5mbit_250ms, cancel, 12,6203,5505,7777,1574
5mbit_250ms, cancel, 19,9871,8480,11986,2115
5mbit_250ms, cancel, 12,4984,4255,6011,1027
5mbit_500ms, cancel, 13,2242,2029,2865,623
5mbit_500ms, cancel, 14,2614,2278,3213,599
5mbit_500ms, cancel, 15,3005,2551,3601,596
5mbit_500ms, cancel, 20,3760,3148,4446,686
5mbit_500ms, cancel, 17,3305,2819,3969,664
5mbit_500ms, cancel, 13,2492,2224,3139,647
5mbit_500ms, cancel, 14,2614,2280,3216,602
5mbit_500ms, cancel, 12,2243,2105,2971,728
5mbit_500ms, cancel, 13,2501,2223,3137,636
5mbit_500ms, cancel, 14,2493,2299,3243,750
5mbit_500ms, cancel, 19,3538,2949,4164,626
5mbit_500ms, cancel, 12,1400,62613,88533,87133
5mbit_500ms, cancel, 17,3250,2727,3850,600
5mbit_500ms, cancel, 16,3001,2609,3683,682
5mbit_500ms, cancel, 15,2752,2390,3373,621
5mbit_50ms, cancel, 15,8663,7619,10770,2107
5mbit_50ms, cancel, 20,11638,9727,13748,2110
5mbit_50ms, cancel, 13,7515,6612,9344,1829
5mbit_50ms, cancel, 14,6702,5671,8013,1311
5mbit_50ms, cancel, 18,10433,8931,12620,2187
5mbit_50ms, cancel, 14,8079,7000,9890,1811
5mbit_50ms, cancel, 12,6917,6100,8618,1701
5mbit_50ms, cancel, 19,11054,9298,13143,2089
5mbit_50ms, cancel, 12,6884,6066,8570,1686
5mbit_50ms, cancel, 19,11016,9286,13126,2110
5mbit_50ms, cancel, 15,8687,7519,10625,1938
5mbit_50ms, cancel, 17,9840,8516,12037,2197
5mbit_50ms, cancel, 13,7478,6635,9375,1897
5mbit_50ms, cancel, 17,9831,8383,11848,2017
5mbit_50ms, cancel, 19,11025,9329,13186,2161
100mbit_0ms, close, 19,54482,39254,55498,1016
100mbit_0ms, close, 19,68699,49314,69727,1028
100mbit_0ms, close, 19,68192,48956,69222,1030
100mbit_0ms, close, 19,66085,47468,67113,1028
100mbit_0ms, close, 19,31881,23032,32561,680
100mbit_0ms, close, 19,66216,47538,67214,998
100mbit_0ms, close, 19,67363,48371,68391,1028
100mbit_0ms, close, 19,67139,47899,67725,586
100mbit_0ms, close, 19,19875,14628,20681,806
100mbit_0ms, close, 13,43986,31830,45002,1016
100mbit_0ms, close, 11,36125,26277,37150,1025
100mbit_0ms, close, 15,52672,37982,53700,1028
100mbit_0ms, close, 17,13078,9723,13742,664
100mbit_0ms, close, 13,4113,3148,4445,332
100mbit_0ms, close, 18,60135,43258,61163,1028
100mbit_100ms, close, 19,58590,42168,59617,1027
100mbit_100ms, close, 19,64695,46481,65717,1022
100mbit_100ms, close, 19,61171,43978,62183,1012
100mbit_100ms, close, 19,65050,46737,66078,1028
100mbit_100ms, close, 19,64781,46544,65808,1027
100mbit_100ms, close, 16,46716,33767,47741,1025
100mbit_100ms, close, 15,12101,9060,12808,707
100mbit_100ms, close, 17,58245,41783,59076,831
100mbit_100ms, close, 13,37854,27356,38679,825
100mbit_100ms, close, 11,31470,22856,32316,846
100mbit_100ms, close, 12,40270,29194,41276,1006
100mbit_100ms, close, 13,36596,26520,37496,900
100mbit_100ms, close, 11,30963,22469,31766,803
100mbit_100ms, close, 15,43217,31262,44203,986
100mbit_100ms, close, 17,48874,35249,49839,965
100mbit_250ms, close, 17,46281,33340,47141,860
100mbit_250ms, close, 20,57694,41516,58702,1008
100mbit_250ms, close, 17,18728,13958,19734,1006
100mbit_250ms, close, 20,37996,27524,38917,921
100mbit_250ms, close, 14,32429,23665,33457,1028
100mbit_250ms, close, 19,32656,23823,33681,1025
100mbit_250ms, close, 16,24520,17941,25365,845
100mbit_250ms, close, 15,39331,28536,40348,1017
100mbit_250ms, close, 14,37387,27136,38368,981
100mbit_250ms, close, 19,53749,38686,54701,952
100mbit_250ms, close, 19,53159,38324,54187,1028
100mbit_250ms, close, 16,26353,19256,27224,871
100mbit_250ms, close, 15,41325,29956,42347,1022
100mbit_250ms, close, 14,36219,26300,37186,967
100mbit_250ms, close, 19,52639,37946,53654,1015
100mbit_500ms, close, 16,3000,2218,3130,130
100mbit_500ms, close, 16,3011,2226,3141,130
100mbit_500ms, close, 19,3519,2585,3647,128
100mbit_500ms, close, 19,3642,2672,3772,130
100mbit_500ms, close, 13,2369,1772,2499,130
100mbit_500ms, close, 18,3380,2482,3506,126
100mbit_500ms, close, 15,2742,2036,2872,130
100mbit_500ms, close, 17,3169,2298,3246,77
100mbit_500ms, close, 17,3126,2302,3251,125
100mbit_500ms, close, 20,3763,2758,3893,130
100mbit_500ms, close, 11,1861,1408,1987,126
100mbit_500ms, close, 15,2758,2046,2888,130
100mbit_500ms, close, 14,2502,1862,2629,127
100mbit_500ms, close, 13,2375,1773,2502,127
100mbit_500ms, close, 18,3372,2480,3502,130
100mbit_50ms, close, 12,33573,24328,34396,823
100mbit_50ms, close, 13,40716,29399,41568,852
100mbit_50ms, close, 11,28862,21044,29753,891
100mbit_50ms, close, 12,3154,2536,3582,428
100mbit_50ms, close, 13,1704,1366,1928,224
100mbit_50ms, close, 18,28034,20122,28450,416
100mbit_50ms, close, 11,29660,21610,30553,893
100mbit_50ms, close, 15,49432,35686,50456,1024
100mbit_50ms, close, 17,51102,36869,52129,1027
100mbit_50ms, close, 20,50048,35921,50789,741
100mbit_50ms, close, 17,52242,37668,53259,1017
100mbit_50ms, close, 13,37240,27064,38265,1025
100mbit_50ms, close, 11,18313,13318,18829,516
100mbit_50ms, close, 15,34892,25222,35660,768
100mbit_50ms, close, 17,51672,37196,52593,921
10mbit_0ms, close, 14,14000,10018,14162,162
10mbit_0ms, close, 16,17311,12445,17594,283
10mbit_0ms, close, 12,14039,10081,14247,208
10mbit_0ms, close, 20,23420,16766,23702,282
10mbit_0ms, close, 17,19855,14229,20117,262
10mbit_0ms, close, 13,15145,10911,15424,279
10mbit_0ms, close, 18,20680,14832,20968,288
10mbit_0ms, close, 18,14567,10493,14834,267
10mbit_0ms, close, 11,6632,4896,6920,288
10mbit_0ms, close, 12,11893,8616,12180,287
10mbit_0ms, close, 20,23296,16644,23532,236
10mbit_0ms, close, 17,19759,14083,19909,150
10mbit_0ms, close, 13,14998,10805,15272,274
10mbit_0ms, close, 18,18864,13540,19143,279
10mbit_0ms, close, 18,19315,13916,19673,358
10mbit_100ms, close, 18,20487,15217,21514,1027
10mbit_100ms, close, 11,12314,9208,13016,702
10mbit_100ms, close, 15,16976,12735,18003,1027
10mbit_100ms, close, 17,19359,14420,20384,1025
10mbit_100ms, close, 20,22856,16894,23883,1027
10mbit_100ms, close, 17,19387,14439,20412,1025
10mbit_100ms, close, 13,14667,10966,15503,836
10mbit_100ms, close, 11,12226,9275,13110,884
10mbit_100ms, close, 15,16535,12320,17416,881
10mbit_100ms, close, 17,19308,14370,20316,1008
10mbit_100ms, close, 20,22881,16911,23908,1027
10mbit_100ms, close, 17,19259,14350,20282,1023
10mbit_100ms, close, 13,11300,8594,12149,849
10mbit_100ms, close, 11,10032,7581,10713,681
10mbit_100ms, close, 15,17006,12755,18033,1027
10mbit_250ms, close, 12,12078,9219,13031,953
10mbit_250ms, close, 13,11862,8909,12593,731
10mbit_250ms, close, 11,9823,7386,10439,616
10mbit_250ms, close, 19,19431,14471,20458,1027
10mbit_250ms, close, 19,20258,15056,21285,1027
10mbit_250ms, close, 19,19266,14356,20291,1025
10mbit_250ms, close, 16,15575,11666,16491,916
10mbit_250ms, close, 15,15657,11741,16597,940
10mbit_250ms, close, 17,17736,13228,18701,965
10mbit_250ms, close, 20,21534,15957,22560,1026
10mbit_250ms, close, 17,18020,13429,18986,966
10mbit_250ms, close, 20,20552,15263,21579,1027
10mbit_250ms, close, 17,16798,12609,17825,1027
10mbit_250ms, close, 13,13337,10097,14274,937
10mbit_250ms, close, 18,18061,13502,19086,1025
10mbit_500ms, close, 17,3247,2400,3376,129
10mbit_500ms, close, 13,2375,1775,2505,130
10mbit_500ms, close, 18,3382,2487,3512,130
10mbit_500ms, close, 15,2752,2041,2881,129
10mbit_500ms, close, 14,2619,1948,2748,129
10mbit_500ms, close, 13,2481,1849,2609,128
10mbit_500ms, close, 18,3503,2574,3633,130
10mbit_500ms, close, 15,2863,2120,2991,128
10mbit_500ms, close, 17,3119,2301,3249,130
10mbit_500ms, close, 20,3884,2841,4012,128
10mbit_500ms, close, 11,1863,1410,1990,127
10mbit_500ms, close, 12,2112,1589,2242,130
10mbit_500ms, close, 17,3151,2320,3277,126
10mbit_500ms, close, 20,3882,2842,4012,130
10mbit_500ms, close, 11,1977,1491,2103,126
10mbit_50ms, close, 16,17801,13076,18487,686
10mbit_50ms, close, 12,2458,1890,2669,211
10mbit_50ms, close, 20,22344,16531,23371,1027
10mbit_50ms, close, 17,19584,14577,20608,1024
10mbit_50ms, close, 20,20063,14616,20664,601
10mbit_50ms, close, 17,18011,13464,19035,1024
10mbit_50ms, close, 13,14543,10862,15354,811
10mbit_50ms, close, 11,2819,2267,3201,382
10mbit_50ms, close, 19,19722,14627,20678,956
10mbit_50ms, close, 19,19090,14190,20062,972
10mbit_50ms, close, 19,14025,10074,14242,217
10mbit_50ms, close, 19,20084,14739,20838,754
10mbit_50ms, close, 19,21511,15804,22344,833
10mbit_50ms, close, 19,18700,13815,19532,832
10mbit_50ms, close, 13,7612,5768,8153,541
50mbit_0ms, close, 20,63147,45226,63944,797
50mbit_0ms, close, 17,52125,37579,53133,1008
50mbit_0ms, close, 13,43116,30996,43823,707
50mbit_0ms, close, 11,39343,28482,40269,926
50mbit_0ms, close, 15,51865,37365,52831,966
50mbit_0ms, close, 17,58393,42028,59421,1028
50mbit_0ms, close, 13,43906,31446,44459,553
50mbit_0ms, close, 18,62338,44608,63064,726
50mbit_0ms, close, 11,38586,27990,39573,987
50mbit_0ms, close, 15,53160,38324,54185,1025
50mbit_0ms, close, 17,60618,43573,61606,988
50mbit_0ms, close, 13,41419,29932,42322,903
50mbit_0ms, close, 11,38334,27782,39281,947
50mbit_0ms, close, 15,49326,35378,50019,693
50mbit_0ms, close, 17,56364,40466,57215,851
50mbit_100ms, close, 19,55204,39766,56228,1024
50mbit_100ms, close, 19,61927,44533,62965,1038
50mbit_100ms, close, 19,22843,16588,23453,610
50mbit_100ms, close, 16,5532,4142,5852,320
50mbit_100ms, close, 12,30018,21698,30679,661
50mbit_100ms, close, 13,41888,30358,42916,1028
50mbit_100ms, close, 18,58230,41909,59257,1027
50mbit_100ms, close, 11,19281,14369,20309,1028
50mbit_100ms, close, 15,41748,30181,42674,926
50mbit_100ms, close, 17,53911,38856,54935,1024
50mbit_100ms, close, 13,7211,5660,8000,789
50mbit_100ms, close, 18,49815,35958,50843,1028
50mbit_100ms, close, 18,59339,42695,60363,1024
50mbit_100ms, close, 11,33716,24512,34656,940
50mbit_100ms, close, 15,20756,15379,21740,984
50mbit_250ms, close, 18,16392,12306,17398,1006
50mbit_250ms, close, 15,19998,14749,20851,853
50mbit_250ms, close, 17,44511,32192,45518,1007
50mbit_250ms, close, 13,33566,24462,34587,1021
50mbit_250ms, close, 18,49623,35822,50649,1026
50mbit_250ms, close, 11,18437,13553,19160,723
50mbit_250ms, close, 15,39212,28282,39989,777
50mbit_250ms, close, 14,34911,25414,35933,1022
50mbit_250ms, close, 19,36698,26674,37715,1017
50mbit_250ms, close, 19,51267,36978,52285,1018
50mbit_250ms, close, 16,41850,30326,42878,1028
50mbit_250ms, close, 15,38160,27676,39132,972
50mbit_250ms, close, 17,13209,10044,14199,990
50mbit_250ms, close, 20,53858,38818,54886,1028
50mbit_250ms, close, 17,45349,32800,46376,1027
50mbit_500ms, close, 12,2106,1586,2236,130
50mbit_500ms, close, 17,3130,2304,3254,124
50mbit_500ms, close, 20,3766,2756,3893,127
50mbit_500ms, close, 14,2492,1858,2621,129
50mbit_500ms, close, 13,2366,1764,2491,125
50mbit_500ms, close, 18,3383,2488,3512,129
50mbit_500ms, close, 15,2737,2029,2864,127
50mbit_500ms, close, 14,2622,1950,2751,129
50mbit_500ms, close, 13,2363,1768,2493,130
50mbit_500ms, close, 18,3387,2492,3517,130
50mbit_500ms, close, 15,2747,2034,2872,125
50mbit_500ms, close, 17,3250,2394,3380,130
50mbit_500ms, close, 17,3128,2308,3257,129
50mbit_500ms, close, 20,3768,2756,3893,125
50mbit_500ms, close, 14,2493,1860,2624,131
50mbit_50ms, close, 16,45153,32650,46165,1012
50mbit_50ms, close, 15,38553,27982,39563,1010
50mbit_50ms, close, 17,47459,34291,48483,1024
50mbit_50ms, close, 13,37407,27180,38425,1018
50mbit_50ms, close, 18,11528,8787,12419,891
50mbit_50ms, close, 15,18629,13486,19066,437
50mbit_50ms, close, 11,29969,21917,30987,1018
50mbit_50ms, close, 15,29448,21553,30471,1023
50mbit_50ms, close, 17,17294,12534,17720,426
50mbit_50ms, close, 20,60158,43273,61184,1026
50mbit_50ms, close, 17,43910,31615,44700,790
50mbit_50ms, close, 20,15723,11845,16746,1023
50mbit_50ms, close, 14,3570,2804,3961,391
50mbit_50ms, close, 16,24918,17960,25393,475
50mbit_50ms, close, 12,37506,27203,38462,956
5mbit_0ms, close, 11,4579,3398,4798,219
5mbit_0ms, close, 15,8785,6380,9015,230
5mbit_0ms, close, 14,8181,5948,8406,225
5mbit_0ms, close, 13,4564,3464,4895,331
5mbit_0ms, close, 18,9287,6756,9547,260
5mbit_0ms, close, 11,6362,4654,6577,215
5mbit_0ms, close, 15,8787,6300,8905,118
5mbit_0ms, close, 14,8178,5878,8308,130
5mbit_0ms, close, 13,7611,5549,7843,232
5mbit_0ms, close, 11,6429,4708,6652,223
5mbit_0ms, close, 12,6866,5008,7074,208
5mbit_0ms, close, 20,11703,8432,11918,215
5mbit_0ms, close, 14,8191,5887,8321,130
5mbit_0ms, close, 16,9359,6709,9482,123
5mbit_0ms, close, 12,7000,5112,7224,224
5mbit_100ms, close, 14,7973,6069,8577,604
5mbit_100ms, close, 19,10935,8189,11569,634
5mbit_100ms, close, 19,10906,8165,11541,635
5mbit_100ms, close, 16,9092,6879,9722,630
5mbit_100ms, close, 15,8584,6511,9203,619
5mbit_100ms, close, 14,7973,6079,8591,618
5mbit_100ms, close, 19,10897,8159,11534,637
5mbit_100ms, close, 19,10928,8178,11559,631
5mbit_100ms, close, 19,10941,8191,11577,636
5mbit_100ms, close, 16,9181,6959,9835,654
5mbit_100ms, close, 15,8598,6529,9227,629
5mbit_100ms, close, 14,7890,5984,8455,565
5mbit_100ms, close, 16,9176,6935,9801,625
5mbit_100ms, close, 15,8536,6497,9179,643
5mbit_100ms, close, 14,7996,6092,8611,615
5mbit_250ms, close, 12,6265,4809,6795,530
5mbit_250ms, close, 13,6447,4910,6939,492
5mbit_250ms, close, 11,5637,4321,6105,468
5mbit_250ms, close, 12,6279,4859,6863,584
5mbit_250ms, close, 13,6754,5198,7345,591
5mbit_250ms, close, 18,9516,7140,10093,577
5mbit_250ms, close, 18,9888,7331,10361,473
5mbit_250ms, close, 18,9808,7281,10291,483
5mbit_250ms, close, 18,9783,7350,10390,607
5mbit_250ms, close, 18,9486,7145,10100,614
5mbit_250ms, close, 11,5433,4156,5872,439
5mbit_250ms, close, 12,6196,4766,6733,537
5mbit_250ms, close, 20,10745,8029,11348,603
5mbit_250ms, close, 17,8447,6252,8834,387
5mbit_250ms, close, 20,10995,8115,11471,476
5mbit_500ms, close, 13,2369,1786,2499,130
5mbit_500ms, close, 18,14284,10762,15214,930
5mbit_500ms, close, 18,5759,4296,6068,309
5mbit_500ms, close, 15,2874,2127,3003,129
5mbit_500ms, close, 17,3377,2484,3506,129
5mbit_500ms, close, 20,4016,2935,4145,129
5mbit_500ms, close, 11,1990,1503,2120,130
5mbit_500ms, close, 12,2115,1586,2239,124
5mbit_500ms, close, 17,3374,2479,3500,126
5mbit_500ms, close, 13,2366,1770,2496,130
5mbit_500ms, close, 18,3510,2578,3639,129
5mbit_500ms, close, 15,4193,3140,4436,243
5mbit_500ms, close, 11,2233,1672,2361,128
5mbit_500ms, close, 12,2368,1769,2496,128
5mbit_500ms, close, 17,3382,2482,3506,124
5mbit_50ms, close, 13,7474,5706,8065,591
5mbit_50ms, close, 11,6355,4848,6850,495
5mbit_50ms, close, 12,6900,5276,7455,555
5mbit_50ms, close, 13,7506,5701,8056,550
5mbit_50ms, close, 11,3305,2547,3596,291
5mbit_50ms, close, 12,6819,5214,7368,549
5mbit_50ms, close, 13,7446,5634,7963,517
5mbit_50ms, close, 11,6276,4794,6774,498
5mbit_50ms, close, 15,8612,6300,8905,293
5mbit_50ms, close, 14,8008,6082,8594,586
5mbit_50ms, close, 16,8785,6656,9408,623
5mbit_50ms, close, 15,6180,4736,6692,512
5mbit_50ms, close, 17,9854,7401,10460,606
5mbit_50ms, close, 13,7533,5686,8037,504
5mbit_50ms, close, 11,6345,4884,6901,556
