url,dataLen,connId,timeForConnect,timeForRequest,timeForResponse,timeForRequestAndResponse
http://156.56.83.24:6003/25kb,26065,1,2380,2689,51212,53901
http://156.56.83.24:6003/25kb,26065,1,2380,4648,52873,57521
http://156.56.83.24:6003/25kb,26065,1,2380,5560,46166,51726
http://156.56.83.24:6003/25kb,26065,1,2380,3204,45916,49120
http://156.56.83.24:6003/25kb,26065,1,2380,2930,47093,50023
http://156.56.83.24:6003/25kb,26065,1,2380,1866,47316,49182
http://156.56.83.24:6003/25kb,26065,1,2380,5517,42691,48208
http://156.56.83.24:6003/25kb,26065,1,2380,5257,44379,49636
http://156.56.83.24:6003/25kb,26065,1,2380,4439,45051,49490
http://156.56.83.24:6003/25kb,26065,1,2380,4021,46533,50554
http://156.56.83.24:6003/25kb,26065,1,2380,2478,49323,51801
http://156.56.83.24:6003/25kb,26065,1,2380,5791,44777,50568
http://156.56.83.24:6003/25kb,26065,1,2380,4172,44789,48961
http://156.56.83.24:6003/25kb,26065,1,2380,3480,49467,52947
http://156.56.83.24:6003/25kb,26065,1,2380,3354,45528,48882
http://156.56.83.24:6003/25kb,26065,1,2380,1932,50005,51937
http://156.56.83.24:6003/25kb,26065,1,2380,1746,50112,51858
http://156.56.83.24:6003/25kb,26065,1,2380,5190,44997,50187
http://156.56.83.24:6003/25kb,26065,1,2380,3262,52543,55805
http://156.56.83.24:6003/25kb,26065,1,2380,4252,46610,50862
http://156.56.83.24:6003/25kb,26065,1,2380,5440,44095,49535
http://156.56.83.24:6003/25kb,26065,1,2380,4578,45532,50110
http://156.56.83.24:6003/25kb,26065,1,2380,5251,43821,49072
http://156.56.83.24:6003/25kb,26065,1,2380,4362,51344,55706
http://156.56.83.24:6003/25kb,26065,1,2380,3275,47372,50647
http://156.56.83.24:6003/25kb,26065,1,2380,1925,46612,48537
http://156.56.83.24:6003/25kb,26065,1,2380,4844,48038,52882
http://156.56.83.24:6003/25kb,26065,1,2380,2031,50352,52383
http://156.56.83.24:6003/25kb,26065,1,2380,3684,47432,51116
http://156.56.83.24:6003/25kb,26065,1,2380,4095,44513,48608
http://156.56.83.24:6003/25kb,26065,1,2380,2900,47999,50899
http://156.56.83.24:6003/25kb,26065,1,2380,1822,46735,48557
http://156.56.83.24:6003/25kb,26065,1,2380,2541,48916,51457
http://156.56.83.24:6003/25kb,26065,1,2380,4654,47591,52245
http://156.56.83.24:6003/25kb,26065,1,2380,2570,48050,50620
http://156.56.83.24:6003/25kb,26065,1,2380,2994,47900,50894
http://156.56.83.24:6003/25kb,26065,1,2380,6137,45575,51712
http://156.56.83.24:6003/25kb,26065,1,2380,5453,45275,50728
http://156.56.83.24:6003/25kb,26065,1,2380,2182,49983,52165
http://156.56.83.24:6003/25kb,26065,1,2380,4846,45078,49924
http://156.56.83.24:6003/25kb,26065,1,2380,3150,45126,48276
http://156.56.83.24:6003/25kb,26065,1,2380,3877,45310,49187
http://156.56.83.24:6003/25kb,26065,1,2380,1778,48270,50048
http://156.56.83.24:6003/25kb,26065,1,2380,4276,48388,52664
http://156.56.83.24:6003/25kb,26065,1,2380,2785,51606,54391
http://156.56.83.24:6003/25kb,26065,1,2380,4532,47296,51828
http://156.56.83.24:6003/25kb,26065,1,2380,3624,46659,50283
http://156.56.83.24:6003/25kb,26065,1,2380,3730,45824,49554
http://156.56.83.24:6003/25kb,26065,1,2380,4333,46073,50406
http://156.56.83.24:6003/25kb,26065,1,2380,3260,47977,51237
http://156.56.83.24:6003/25kb,26065,1,2380,2304,46921,49225
http://156.56.83.24:6003/25kb,26065,1,2380,5501,44729,50230
http://156.56.83.24:6003/25kb,26065,1,2380,1930,47243,49173
http://156.56.83.24:6003/25kb,26065,1,2380,3728,49014,52742
http://156.56.83.24:6003/25kb,26065,1,2380,1990,48749,50739
http://156.56.83.24:6003/25kb,26065,1,2380,3959,47180,51139
http://156.56.83.24:6003/25kb,26065,1,2380,5402,48747,54149
http://156.56.83.24:6003/25kb,26065,1,2380,5379,43749,49128
http://156.56.83.24:6003/25kb,26065,1,2380,3595,45586,49181
http://156.56.83.24:6003/25kb,26065,1,2380,4805,48261,53066
http://156.56.83.24:6003/25kb,26065,1,2380,5155,45410,50565
http://156.56.83.24:6003/25kb,26065,1,2380,2331,50142,52473
http://156.56.83.24:6003/25kb,26065,1,2380,4932,47574,52506
http://156.56.83.24:6003/25kb,26065,1,2380,2160,48092,50252
http://156.56.83.24:6003/25kb,26065,1,2380,2262,47661,49923
http://156.56.83.24:6003/25kb,26065,1,2380,5316,46916,52232
http://156.56.83.24:6003/25kb,26065,1,2380,2426,46342,48768
http://156.56.83.24:6003/25kb,26065,1,2380,4364,47221,51585
http://156.56.83.24:6003/25kb,26065,1,2380,4888,45032,49920
http://156.56.83.24:6003/25kb,26065,1,2380,5378,46322,51700
http://156.56.83.24:6003/25kb,26065,1,2380,2832,49396,52228
http://156.56.83.24:6003/25kb,26065,1,2380,2835,58516,61351
http://156.56.83.24:6003/25kb,26065,1,2380,3285,46731,50016
http://156.56.83.24:6003/25kb,26065,1,2380,4081,45098,49179
http://156.56.83.24:6003/25kb,26065,1,2380,4516,44923,49439
http://156.56.83.24:6003/25kb,26065,1,2380,2930,45938,48868
http://156.56.83.24:6003/25kb,26065,1,2380,3065,46954,50019
http://156.56.83.24:6003/25kb,26065,1,2380,3702,55456,59158
http://156.56.83.24:6003/25kb,26065,1,2380,4723,45219,49942
http://156.56.83.24:6003/25kb,26065,1,2380,4400,45754,50154
http://156.56.83.24:6003/25kb,26065,1,2380,4693,44915,49608
http://156.56.83.24:6003/25kb,26065,1,2380,3173,46949,50122
http://156.56.83.24:6003/25kb,26065,1,2380,3429,46658,50087
http://156.56.83.24:6003/25kb,26065,1,2380,4294,47119,51413
http://156.56.83.24:6003/25kb,26065,1,2380,4550,45692,50242
http://156.56.83.24:6003/25kb,26065,1,2380,5444,44024,49468
http://156.56.83.24:6003/25kb,26065,1,2380,5750,48779,54529
http://156.56.83.24:6003/25kb,26065,1,2380,3052,50664,53716
http://156.56.83.24:6003/25kb,26065,1,2380,3734,45168,48902
http://156.56.83.24:6003/25kb,26065,1,2380,3114,47354,50468
http://156.56.83.24:6003/25kb,26065,1,2380,1796,49234,51030
http://156.56.83.24:6003/25kb,26065,1,2380,4337,46835,51172
http://156.56.83.24:6003/25kb,26065,1,2380,4943,44593,49536
http://156.56.83.24:6003/25kb,26065,1,2380,2389,46726,49115
http://156.56.83.24:6003/25kb,26065,1,2380,1832,48333,50165
http://156.56.83.24:6003/25kb,26065,1,2380,4041,46625,50666
http://156.56.83.24:6003/25kb,26065,1,2380,2594,45664,48258
http://156.56.83.24:6003/25kb,26065,1,2380,4480,45684,50164
http://156.56.83.24:6003/25kb,26065,1,2380,3311,47001,50312
http://156.56.83.24:6003/25kb,26065,1,2380,5758,45470,51228
http://156.56.83.24:6003/25kb,26065,1,2380,3087,47583,50670
http://156.56.83.24:6003/25kb,26065,1,2380,5472,44058,49530
http://156.56.83.24:6003/25kb,26065,1,2380,2932,44463,47395
http://156.56.83.24:6003/25kb,26065,1,2380,2817,46453,49270
http://156.56.83.24:6003/25kb,26065,1,2380,4308,46688,50996
http://156.56.83.24:6003/25kb,26065,1,2380,3933,47382,51315
http://156.56.83.24:6003/25kb,26065,1,2380,3923,46402,50325
http://156.56.83.24:6003/25kb,26065,1,2380,4585,45081,49666
http://156.56.83.24:6003/25kb,26065,1,2380,2307,49830,52137
http://156.56.83.24:6003/25kb,26065,1,2380,2157,48827,50984
http://156.56.83.24:6003/25kb,26065,1,2380,2609,45654,48263
http://156.56.83.24:6003/25kb,26065,1,2380,4124,46005,50129
http://156.56.83.24:6003/25kb,26065,1,2380,3957,46236,50193
http://156.56.83.24:6003/25kb,26065,1,2380,2890,44518,47408
http://156.56.83.24:6003/25kb,26065,1,2380,1768,46587,48355
http://156.56.83.24:6003/25kb,26065,1,2380,4926,45978,50904
http://156.56.83.24:6003/25kb,26065,1,2380,5053,45719,50772
http://156.56.83.24:6003/25kb,26065,1,2380,5654,43270,48924
http://156.56.83.24:6003/25kb,26065,1,2380,2984,44665,47649
http://156.56.83.24:6003/25kb,26065,1,2380,2405,49871,52276
http://156.56.83.24:6003/25kb,26065,1,2380,4534,47816,52350
http://156.56.83.24:6003/25kb,26065,1,2380,2606,45547,48153
http://156.56.83.24:6003/25kb,26065,1,2380,2770,45481,48251
http://156.56.83.24:6003/25kb,26065,1,2380,1876,47721,49597
http://156.56.83.24:6003/25kb,26065,1,2380,2647,47679,50326
http://156.56.83.24:6003/25kb,26065,1,2380,4619,50359,54978
http://156.56.83.24:6003/25kb,26065,1,2380,5666,42720,48386
http://156.56.83.24:6003/25kb,26065,1,2380,5563,46632,52195
http://156.56.83.24:6003/25kb,26065,1,2380,2869,46660,49529
http://156.56.83.24:6003/25kb,26065,1,2380,5793,45406,51199
http://156.56.83.24:6003/25kb,26065,1,2380,3823,47288,51111
http://156.56.83.24:6003/25kb,26065,1,2380,2152,46939,49091
http://156.56.83.24:6003/25kb,26065,1,2380,4260,46520,50780
http://156.56.83.24:6003/25kb,26065,1,2380,2973,49288,52261
http://156.56.83.24:6003/25kb,26065,1,2380,4371,43449,47820
http://156.56.83.24:6003/25kb,26065,1,2380,3582,44811,48393
http://156.56.83.24:6003/25kb,26065,1,2380,5936,44631,50567
http://156.56.83.24:6003/25kb,26065,1,2380,3779,44410,48189
http://156.56.83.24:6003/25kb,26065,1,2380,5762,42343,48105
http://156.56.83.24:6003/25kb,26065,1,2380,3837,44483,48320
http://156.56.83.24:6003/25kb,26065,1,2380,4784,44530,49314
http://156.56.83.24:6003/25kb,26065,1,2380,3152,44466,47618
http://156.56.83.24:6003/25kb,26065,1,2380,5344,45732,51076
http://156.56.83.24:6003/25kb,26065,1,2380,5167,48022,53189
http://156.56.83.24:6003/25kb,26065,1,2380,5524,49669,55193
http://156.56.83.24:6003/25kb,26065,1,2380,2698,45595,48293
http://156.56.83.24:6003/25kb,26065,1,2380,5798,47768,53566
http://156.56.83.24:6003/25kb,26065,1,2380,2056,46470,48526
http://156.56.83.24:6003/25kb,26065,1,2380,2748,46351,49099
http://156.56.83.24:6003/25kb,26065,1,2380,1523,52368,53891
http://156.56.83.24:6003/25kb,26065,1,2380,3760,48300,52060
http://156.56.83.24:6003/25kb,26065,1,2380,2828,46227,49055
http://156.56.83.24:6003/25kb,26065,1,2380,2520,46895,49415
http://156.56.83.24:6003/25kb,26065,1,2380,4460,47557,52017
http://156.56.83.24:6003/25kb,26065,1,2380,3258,47862,51120
http://156.56.83.24:6003/25kb,26065,1,2380,4744,45520,50264
http://156.56.83.24:6003/25kb,26065,1,2380,4601,44557,49158
http://156.56.83.24:6003/25kb,26065,1,2380,1653,50321,51974
http://156.56.83.24:6003/25kb,26065,1,2380,2493,47896,50389
http://156.56.83.24:6003/25kb,26065,1,2380,5868,44175,50043
http://156.56.83.24:6003/25kb,26065,1,2380,3329,45326,48655
http://156.56.83.24:6003/25kb,26065,1,2380,2724,48765,51489
http://156.56.83.24:6003/25kb,26065,1,2380,2246,46006,48252
http://156.56.83.24:6003/25kb,26065,1,2380,3733,45440,49173
http://156.56.83.24:6003/25kb,26065,1,2380,4169,43855,48024
http://156.56.83.24:6003/25kb,26065,1,2380,5231,48266,53497
http://156.56.83.24:6003/25kb,26065,1,2380,2477,47787,50264
http://156.56.83.24:6003/25kb,26065,1,2380,5856,47123,52979
http://156.56.83.24:6003/25kb,26065,1,2380,5026,45250,50276
http://156.56.83.24:6003/25kb,26065,1,2380,3423,47570,50993
http://156.56.83.24:6003/25kb,26065,1,2380,1969,48333,50302
http://156.56.83.24:6003/25kb,26065,1,2380,4959,45799,50758
http://156.56.83.24:6003/25kb,26065,1,2380,4479,45892,50371
http://156.56.83.24:6003/25kb,26065,1,2380,3525,45306,48831
http://156.56.83.24:6003/25kb,26065,1,2380,1824,46717,48541
http://156.56.83.24:6003/25kb,26065,1,2380,2833,44700,47533
http://156.56.83.24:6003/25kb,26065,1,2380,3871,43996,47867
http://156.56.83.24:6003/25kb,26065,1,2380,1763,49416,51179
http://156.56.83.24:6003/25kb,26065,1,2380,16964,38331,55295
http://156.56.83.24:6003/25kb,26065,1,2380,3056,57243,60299
http://156.56.83.24:6003/25kb,26065,1,2380,5832,46542,52374
http://156.56.83.24:6003/25kb,26065,1,2380,5646,45255,50901
http://156.56.83.24:6003/25kb,26065,1,2380,4479,46905,51384
http://156.56.83.24:6003/25kb,26065,1,2380,2212,49786,51998
http://156.56.83.24:6003/25kb,26065,1,2380,5187,44499,49686
http://156.56.83.24:6003/25kb,26065,1,2380,3685,46368,50053
http://156.56.83.24:6003/25kb,26065,1,2380,4981,47730,52711
http://156.56.83.24:6003/25kb,26065,1,2380,5287,47502,52789
http://156.56.83.24:6003/25kb,26065,1,2380,2774,45931,48705
http://156.56.83.24:6003/25kb,26065,1,2380,3143,46341,49484
http://156.56.83.24:6003/25kb,26065,1,2380,4435,45749,50184
http://156.56.83.24:6003/25kb,26065,1,2380,4731,46910,51641
http://156.56.83.24:6003/25kb,26065,1,2380,2570,46788,49358
http://156.56.83.24:6003/25kb,26065,1,2380,3536,46155,49691
http://156.56.83.24:6003/25kb,26065,1,2380,1751,50452,52203
http://156.56.83.24:6003/25kb,26065,1,2380,1830,50605,52435
http://156.56.83.24:6003/25kb,26065,1,2380,4320,46561,50881
http://156.56.83.24:6003/25kb,26065,1,2380,2230,48313,50543
http://156.56.83.24:6003/25kb,26065,1,2380,1635,48021,49656
http://156.56.83.24:6003/25kb,26065,1,2380,3176,50700,53876
