url,dataLen,connId,timeForConnect,timeForRequest,timeForResponse,timeForRequestAndResponse
http://156.56.83.24:6003/25kb,26065,1,53858,112239,222968,335207
http://156.56.83.24:6003/25kb,26065,1,53858,56015,167945,223960
http://156.56.83.24:6003/25kb,26065,1,53858,54511,213174,267685
http://156.56.83.24:6003/25kb,26065,1,53858,53414,293196,346610
http://156.56.83.24:6003/25kb,26065,1,53858,52163,225913,278076
http://156.56.83.24:6003/25kb,26065,1,53858,55600,273259,328859
http://156.56.83.24:6003/25kb,26065,1,53858,53860,326567,380427
http://156.56.83.24:6003/25kb,26065,1,53858,55429,167946,223375
http://156.56.83.24:6003/25kb,26065,1,53858,52410,218011,270421
http://156.56.83.24:6003/25kb,26065,1,53858,57042,217113,274155
http://156.56.83.24:6003/25kb,26065,1,53858,53777,278741,332518
http://156.56.83.24:6003/25kb,26065,1,53858,54362,216111,270473
http://156.56.83.24:6003/25kb,26065,1,53858,55123,278403,333526
http://156.56.83.24:6003/25kb,26065,1,53858,55417,221941,277358
http://156.56.83.24:6003/25kb,26065,1,53858,55572,275372,330944
http://156.56.83.24:6003/25kb,26065,1,53858,55261,223327,278588
http://156.56.83.24:6003/25kb,26065,1,53858,53588,218614,272202
http://156.56.83.24:6003/25kb,26065,1,53858,54654,282358,337012
http://156.56.83.24:6003/25kb,26065,1,53858,52596,270211,322807
http://156.56.83.24:6003/25kb,26065,1,53858,52168,115060,167228
http://156.56.83.24:6003/25kb,26065,1,53858,52121,164865,216986
http://156.56.83.24:6003/25kb,26065,1,53858,52448,280124,332572
http://156.56.83.24:6003/25kb,26065,1,53858,55368,216956,272324
http://156.56.83.24:6003/25kb,26065,1,53858,55108,116157,171265
http://156.56.83.24:6003/25kb,26065,1,53858,52716,275480,328196
http://156.56.83.24:6003/25kb,26065,1,53858,55442,177868,233310
http://156.56.83.24:6003/25kb,26065,1,53858,54339,228133,282472
http://156.56.83.24:6003/25kb,26065,1,53858,52425,161384,213809
http://156.56.83.24:6003/25kb,26065,1,53858,53122,215752,268874
http://156.56.83.24:6003/25kb,26065,1,53858,52461,167546,220007
http://156.56.83.24:6003/25kb,26065,1,53858,52046,273870,325916
http://156.56.83.24:6003/25kb,26065,1,53858,54466,269032,323498
http://156.56.83.24:6003/25kb,26065,1,53858,52312,276517,328829
http://156.56.83.24:6003/25kb,26065,1,53858,54448,270490,324938
http://156.56.83.24:6003/25kb,26065,1,53858,54757,219921,274678
http://156.56.83.24:6003/25kb,26065,1,53858,52518,159802,212320
http://156.56.83.24:6003/25kb,26065,1,53858,53679,274102,327781
http://156.56.83.24:6003/25kb,26065,1,53858,52150,167356,219506
http://156.56.83.24:6003/25kb,26065,1,53858,53825,167690,221515
http://156.56.83.24:6003/25kb,26065,1,53858,53824,219726,273550
http://156.56.83.24:6003/25kb,26065,1,53858,55139,379281,434420
http://156.56.83.24:6003/25kb,26065,1,53858,52592,271440,324032
http://156.56.83.24:6003/25kb,26065,1,53858,52412,488894,541306
http://156.56.83.24:6003/25kb,26065,1,53858,52127,163772,215899
http://156.56.83.24:6003/25kb,26065,1,53858,52112,272426,324538
http://156.56.83.24:6003/25kb,26065,1,53858,54366,274096,328462
http://156.56.83.24:6003/25kb,26065,1,53858,54089,227859,281948
http://156.56.83.24:6003/25kb,26065,1,53858,55887,379512,435399
http://156.56.83.24:6003/25kb,26065,1,53858,54958,273971,328929
http://156.56.83.24:6003/25kb,26065,1,53858,55365,275459,330824
http://156.56.83.24:6003/25kb,26065,1,53858,52987,270736,323723
http://156.56.83.24:6003/25kb,26065,1,53858,53445,268436,321881
http://156.56.83.24:6003/25kb,26065,1,53858,54576,169841,224417
http://156.56.83.24:6003/25kb,26065,1,53858,53988,170034,224022
http://156.56.83.24:6003/25kb,26065,1,53858,52934,282400,335334
http://156.56.83.24:6003/25kb,26065,1,53858,108905,225244,334149
http://156.56.83.24:6003/25kb,26065,1,53858,51976,120945,172921
http://156.56.83.24:6003/25kb,26065,1,53858,53120,216753,269873
http://156.56.83.24:6003/25kb,26065,1,53858,54781,272956,327737
http://156.56.83.24:6003/25kb,26065,1,53858,56569,165382,221951
http://156.56.83.24:6003/25kb,26065,1,53858,53152,168242,221394
http://156.56.83.24:6003/25kb,26065,1,53858,55452,122008,177460
http://156.56.83.24:6003/25kb,26065,1,53858,55205,331448,386653
http://156.56.83.24:6003/25kb,26065,1,53858,89165,440093,529258
http://156.56.83.24:6003/25kb,26065,1,53858,54410,273940,328350
http://156.56.83.24:6003/25kb,26065,1,53858,54630,168458,223088
http://156.56.83.24:6003/25kb,26065,1,53858,52070,220436,272506
http://156.56.83.24:6003/25kb,26065,1,53858,54037,216984,271021
http://156.56.83.24:6003/25kb,26065,1,53858,55735,165363,221098
http://156.56.83.24:6003/25kb,26065,1,53858,54748,222445,277193
http://156.56.83.24:6003/25kb,26065,1,53858,52347,166753,219100
http://156.56.83.24:6003/25kb,26065,1,53858,55553,216121,271674
http://156.56.83.24:6003/25kb,26065,1,53858,53286,382014,435300
http://156.56.83.24:6003/25kb,26065,1,53858,52523,221724,274247
http://156.56.83.24:6003/25kb,26065,1,53858,55007,214874,269881
http://156.56.83.24:6003/25kb,26065,1,53858,54160,383163,437323
http://156.56.83.24:6003/25kb,26065,1,53858,54504,434326,488830
http://156.56.83.24:6003/25kb,26065,1,53858,54048,226158,280206
http://156.56.83.24:6003/25kb,26065,1,53858,54874,219242,274116
http://156.56.83.24:6003/25kb,26065,1,53858,55750,269575,325325
http://156.56.83.24:6003/25kb,26065,1,53858,53597,381657,435254
http://156.56.83.24:6003/25kb,26065,1,53858,53387,180401,233788
http://156.56.83.24:6003/25kb,26065,1,53858,53253,120462,173715
http://156.56.83.24:6003/25kb,26065,1,53858,56015,269262,325277
http://156.56.83.24:6003/25kb,26065,1,53858,54670,270900,325570
http://156.56.83.24:6003/25kb,26065,1,53858,61186,376654,437840
http://156.56.83.24:6003/25kb,26065,1,53858,54169,274238,328407
http://156.56.83.24:6003/25kb,26065,1,53858,55982,272890,328872
http://156.56.83.24:6003/25kb,26065,1,53858,54092,325758,379850
http://156.56.83.24:6003/25kb,26065,1,53858,52169,218675,270844
http://156.56.83.24:6003/25kb,26065,1,53858,54717,268996,323713
http://156.56.83.24:6003/25kb,26065,1,53858,54141,273956,328097
http://156.56.83.24:6003/25kb,26065,1,53858,54258,215781,270039
http://156.56.83.24:6003/25kb,26065,1,53858,53038,221733,274771
http://156.56.83.24:6003/25kb,26065,1,53858,52168,266533,318701
http://156.56.83.24:6003/25kb,26065,1,53858,55288,226293,281581
http://156.56.83.24:6003/25kb,26065,1,53858,53839,162604,216443
http://156.56.83.24:6003/25kb,26065,1,53858,55516,270922,326438
http://156.56.83.24:6003/25kb,26065,1,53858,56104,324776,380880
http://156.56.83.24:6003/25kb,26065,1,53858,53117,169661,222778
http://156.56.83.24:6003/25kb,26065,1,53858,55205,218702,273907
http://156.56.83.24:6003/25kb,26065,1,53858,53908,271951,325859
http://156.56.83.24:6003/25kb,26065,1,53858,55957,270452,326409
http://156.56.83.24:6003/25kb,26065,1,53858,55235,169080,224315
http://156.56.83.24:6003/25kb,26065,1,53858,52867,117394,170261
http://156.56.83.24:6003/25kb,26065,1,53858,95241,219834,315075
http://156.56.83.24:6003/25kb,26065,1,53858,52169,218933,271102
http://156.56.83.24:6003/25kb,26065,1,53858,55598,117997,173595
http://156.56.83.24:6003/25kb,26065,1,53858,51926,213896,265822
http://156.56.83.24:6003/25kb,26065,1,53858,55577,328583,384160
http://156.56.83.24:6003/25kb,26065,1,53858,53499,271383,324882
http://156.56.83.24:6003/25kb,26065,1,53858,52672,118911,171583
http://156.56.83.24:6003/25kb,26065,1,53858,51949,119490,171439
http://156.56.83.24:6003/25kb,26065,1,53858,55409,219196,274605
http://156.56.83.24:6003/25kb,26065,1,53858,53989,269551,323540
http://156.56.83.24:6003/25kb,26065,1,53858,55865,218432,274297
http://156.56.83.24:6003/25kb,26065,1,53858,56068,277097,333165
http://156.56.83.24:6003/25kb,26065,1,53858,53317,275666,328983
http://156.56.83.24:6003/25kb,26065,1,53858,52862,117479,170341
http://156.56.83.24:6003/25kb,26065,1,53858,55178,168597,223775
http://156.56.83.24:6003/25kb,26065,1,53858,53265,323486,376751
http://156.56.83.24:6003/25kb,26065,1,53858,52179,216181,268360
http://156.56.83.24:6003/25kb,26065,1,53858,53385,123050,176435
http://156.56.83.24:6003/25kb,26065,1,53858,52573,220396,272969
http://156.56.83.24:6003/25kb,26065,1,53858,51972,274725,326697
http://156.56.83.24:6003/25kb,26065,1,53858,52828,323281,376109
http://156.56.83.24:6003/25kb,26065,1,53858,53550,390956,444506
http://156.56.83.24:6003/25kb,26065,1,53858,54143,275625,329768
http://156.56.83.24:6003/25kb,26065,1,53858,54601,375209,429810
http://156.56.83.24:6003/25kb,26065,1,53858,52265,331818,384083
http://156.56.83.24:6003/25kb,26065,1,53858,54130,325141,379271
http://156.56.83.24:6003/25kb,26065,1,53858,58230,331751,389981
http://156.56.83.24:6003/25kb,26065,1,53858,54105,219830,273935
http://156.56.83.24:6003/25kb,26065,1,53858,52651,170782,223433
http://156.56.83.24:6003/25kb,26065,1,53858,56023,214937,270960
http://156.56.83.24:6003/25kb,26065,1,53858,53485,217810,271295
http://156.56.83.24:6003/25kb,26065,1,53858,54520,167890,222410
http://156.56.83.24:6003/25kb,26065,1,53858,53007,268702,321709
http://156.56.83.24:6003/25kb,26065,1,53858,55552,218905,274457
http://156.56.83.24:6003/25kb,26065,1,53858,52190,160652,212842
http://156.56.83.24:6003/25kb,26065,1,53858,52807,268030,320837
http://156.56.83.24:6003/25kb,26065,1,53858,51986,169317,221303
http://156.56.83.24:6003/25kb,26065,1,53858,51677,318728,370405
http://156.56.83.24:6003/25kb,26065,1,53858,54489,216228,270717
http://156.56.83.24:6003/25kb,26065,1,53858,54262,124596,178858
http://156.56.83.24:6003/25kb,26065,1,53858,53957,118660,172617
http://156.56.83.24:6003/25kb,26065,1,53858,110128,164949,275077
http://156.56.83.24:6003/25kb,26065,1,53858,54871,171317,226188
http://156.56.83.24:6003/25kb,26065,1,53858,54183,219957,274140
http://156.56.83.24:6003/25kb,26065,1,53858,52214,163432,215646
http://156.56.83.24:6003/25kb,26065,1,53858,53027,217704,270731
http://156.56.83.24:6003/25kb,26065,1,53858,53591,220762,274353
http://156.56.83.24:6003/25kb,26065,1,53858,54932,169044,223976
http://156.56.83.24:6003/25kb,26065,1,53858,53894,225512,279406
http://156.56.83.24:6003/25kb,26065,1,53858,53626,223456,277082
http://156.56.83.24:6003/25kb,26065,1,53858,53594,267118,320712
http://156.56.83.24:6003/25kb,26065,1,53858,53774,118365,172139
http://156.56.83.24:6003/25kb,26065,1,53858,55989,329150,385139
http://156.56.83.24:6003/25kb,26065,1,53858,53916,219631,273547
http://156.56.83.24:6003/25kb,26065,1,53858,54607,218486,273093
http://156.56.83.24:6003/25kb,26065,1,53858,54982,225528,280510
http://156.56.83.24:6003/25kb,26065,1,53858,54573,275819,330392
http://156.56.83.24:6003/25kb,26065,1,53858,52059,217490,269549
http://156.56.83.24:6003/25kb,26065,1,53858,52404,323696,376100
http://156.56.83.24:6003/25kb,26065,1,53858,53839,117578,171417
http://156.56.83.24:6003/25kb,26065,1,53858,55460,162855,218315
http://156.56.83.24:6003/25kb,26065,1,53858,55581,278445,334026
http://156.56.83.24:6003/25kb,26065,1,53858,55795,162478,218273
http://156.56.83.24:6003/25kb,26065,1,53858,55888,269899,325787
http://156.56.83.24:6003/25kb,26065,1,53858,52840,168999,221839
http://156.56.83.24:6003/25kb,26065,1,53858,52763,219460,272223
http://156.56.83.24:6003/25kb,26065,1,53858,53994,219795,273789
http://156.56.83.24:6003/25kb,26065,1,53858,53381,169026,222407
http://156.56.83.24:6003/25kb,26065,1,53858,53934,319956,373890
http://156.56.83.24:6003/25kb,26065,1,53858,54282,178360,232642
http://156.56.83.24:6003/25kb,26065,1,53858,55766,216286,272052
http://156.56.83.24:6003/25kb,26065,1,53858,54805,165683,220488
http://156.56.83.24:6003/25kb,26065,1,53858,53895,214641,268536
http://156.56.83.24:6003/25kb,26065,1,53858,55171,216199,271370
http://156.56.83.24:6003/25kb,26065,1,53858,53665,173119,226784
http://156.56.83.24:6003/25kb,26065,1,53858,54822,174764,229586
http://156.56.83.24:6003/25kb,26065,1,53858,53111,328726,381837
http://156.56.83.24:6003/25kb,26065,1,53858,52046,170244,222290
http://156.56.83.24:6003/25kb,26065,1,53858,53345,272845,326190
http://156.56.83.24:6003/25kb,26065,1,53858,52120,379678,431798
http://156.56.83.24:6003/25kb,26065,1,53858,52755,217412,270167
http://156.56.83.24:6003/25kb,26065,1,53858,52030,165597,217627
http://156.56.83.24:6003/25kb,26065,1,53858,53074,216584,269658
http://156.56.83.24:6003/25kb,26065,1,53858,52613,220944,273557
http://156.56.83.24:6003/25kb,26065,1,53858,54145,324769,378914
http://156.56.83.24:6003/25kb,26065,1,53858,53710,168675,222385
http://156.56.83.24:6003/25kb,26065,1,53858,53790,169616,223406
http://156.56.83.24:6003/25kb,26065,1,53858,53746,217527,271273
http://156.56.83.24:6003/25kb,26065,1,53858,52218,113838,166056
http://156.56.83.24:6003/25kb,26065,1,53858,54155,333021,387176
http://156.56.83.24:6003/25kb,26065,1,53858,57881,221304,279185
http://156.56.83.24:6003/25kb,26065,1,53858,53724,171587,225311
http://156.56.83.24:6003/25kb,26065,1,53858,54536,271508,326044
http://156.56.83.24:6003/25kb,26065,1,53858,55063,273478,328541
http://156.56.83.24:6003/25kb,26065,1,53858,53998,217839,271837
