http://156.56.83.24:6003/25kb,26065,1,6436,15692,41156,56848
http://156.56.83.24:6003/25kb,26065,1,6436,14116,37785,51901
http://156.56.83.24:6003/25kb,26065,1,6436,12450,36760,49210
http://156.56.83.24:6003/25kb,26065,1,6436,16049,34725,50774
http://156.56.83.24:6003/25kb,26065,1,6436,11188,42250,53438
http://156.56.83.24:6003/25kb,26065,1,6436,12557,32517,45074
http://156.56.83.24:6003/25kb,26065,1,6436,14239,29434,43673
http://156.56.83.24:6003/25kb,26065,1,6436,13911,35996,49907
http://156.56.83.24:6003/25kb,26065,1,6436,39201,16940,56141
http://156.56.83.24:6003/25kb,26065,1,6436,9890,44816,54706
http://156.56.83.24:6003/25kb,26065,1,6436,8109,41628,49737
http://156.56.83.24:6003/25kb,26065,1,6436,14553,33982,48535
http://156.56.83.24:6003/25kb,26065,1,6436,8475,38775,47250
http://156.56.83.24:6003/25kb,26065,1,6436,11471,30544,42015
http://156.56.83.24:6003/25kb,26065,1,6436,11484,28086,39570
http://156.56.83.24:6003/25kb,26065,1,6436,8466,29799,38265
http://156.56.83.24:6003/25kb,26065,1,6436,8209,29257,37466
http://156.56.83.24:6003/25kb,26065,1,6436,11115,28569,39684
http://156.56.83.24:6003/25kb,26065,1,6436,10539,31459,41998
http://156.56.83.24:6003/25kb,26065,1,6436,11113,43342,54455
http://156.56.83.24:6003/25kb,26065,1,6436,12358,42017,54375
http://156.56.83.24:6003/25kb,26065,1,6436,13984,34860,48844
http://156.56.83.24:6003/25kb,26065,1,6436,16282,35384,51666
http://156.56.83.24:6003/25kb,26065,1,6436,12964,37125,50089
http://156.56.83.24:6003/25kb,26065,1,6436,17139,37065,54204
http://156.56.83.24:6003/25kb,26065,1,6436,15802,40352,56154
http://156.56.83.24:6003/25kb,26065,1,6436,15543,38870,54413
http://156.56.83.24:6003/25kb,26065,1,6436,14507,31468,45975
http://156.56.83.24:6003/25kb,26065,1,6436,12483,38342,50825
http://156.56.83.24:6003/25kb,26065,1,6436,15043,27894,42937
http://156.56.83.24:6003/25kb,26065,1,6436,10740,31176,41916
http://156.56.83.24:6003/25kb,26065,1,6436,12605,30218,42823
http://156.56.83.24:6003/25kb,26065,1,6436,12208,31266,43474
http://156.56.83.24:6003/25kb,26065,1,6436,37276,19121,56397
http://156.56.83.24:6003/25kb,26065,1,6436,9557,31116,40673
http://156.56.83.24:6003/25kb,26065,1,6436,12823,34193,47016
http://156.56.83.24:6003/25kb,26065,1,6436,9805,34247,44052
http://156.56.83.24:6003/25kb,26065,1,6436,9437,34103,43540
http://156.56.83.24:6003/25kb,26065,1,6436,11660,48292,59952
http://156.56.83.24:6003/25kb,26065,1,6436,14918,41699,56617
http://156.56.83.24:6003/25kb,26065,1,6436,15069,43906,58975
http://156.56.83.24:6003/25kb,26065,1,6436,12724,52270,64994
http://156.56.83.24:6003/25kb,26065,1,6436,8983,55394,64377
http://156.56.83.24:6003/25kb,26065,1,6436,11934,45905,57839
http://156.56.83.24:6003/25kb,26065,1,6436,12668,35966,48634
http://156.56.83.24:6003/25kb,26065,1,6436,10820,269522,280342
http://156.56.83.24:6003/25kb,26065,1,6436,9868,35288,45156
http://156.56.83.24:6003/25kb,26065,1,6436,13045,41635,54680
http://156.56.83.24:6003/25kb,26065,1,6436,77336,31533,108869
http://156.56.83.24:6003/25kb,26065,1,6436,9153,41418,50571
http://156.56.83.24:6003/25kb,26065,1,6436,12551,38512,51063
http://156.56.83.24:6003/25kb,26065,1,6436,7279,42919,50198
http://156.56.83.24:6003/25kb,26065,1,6436,34621,37448,72069
http://156.56.83.24:6003/25kb,26065,1,6436,14997,35830,50827
http://156.56.83.24:6003/25kb,26065,1,6436,9978,45846,55824
http://156.56.83.24:6003/25kb,26065,1,6436,9890,45111,55001
http://156.56.83.24:6003/25kb,26065,1,6436,14098,37393,51491
http://156.56.83.24:6003/25kb,26065,1,6436,9702,40266,49968
http://156.56.83.24:6003/25kb,26065,1,6436,9502,39635,49137
http://156.56.83.24:6003/25kb,26065,1,6436,10223,42190,52413
http://156.56.83.24:6003/25kb,26065,1,6436,10727,59772,70499
http://156.56.83.24:6003/25kb,26065,1,6436,9542,36943,46485
http://156.56.83.24:6003/25kb,26065,1,6436,10892,37679,48571
http://156.56.83.24:6003/25kb,26065,1,6436,12520,41475,53995
http://156.56.83.24:6003/25kb,26065,1,6436,10013,34151,44164
http://156.56.83.24:6003/25kb,26065,1,6436,11282,41770,53052
http://156.56.83.24:6003/25kb,26065,1,6436,4652,34629,39281
http://156.56.83.24:6003/25kb,26065,1,6436,10398,41687,52085
http://156.56.83.24:6003/25kb,26065,1,6436,10403,44969,55372
http://156.56.83.24:6003/25kb,26065,1,6436,10979,53075,64054
http://156.56.83.24:6003/25kb,26065,1,6436,9882,40094,49976
http://156.56.83.24:6003/25kb,26065,1,6436,12227,37633,49860
http://156.56.83.24:6003/25kb,26065,1,6436,10605,54208,64813
http://156.56.83.24:6003/25kb,26065,1,6436,14619,55451,70070
http://156.56.83.24:6003/25kb,26065,1,6436,13123,49948,63071
http://156.56.83.24:6003/25kb,26065,1,6436,17200,46513,63713
http://156.56.83.24:6003/25kb,26065,1,6436,12704,41987,54691
http://156.56.83.24:6003/25kb,26065,1,6436,9519,37115,46634
http://156.56.83.24:6003/25kb,26065,1,6436,11001,39175,50176
http://156.56.83.24:6003/25kb,26065,1,6436,12362,41538,53900
http://156.56.83.24:6003/25kb,26065,1,6436,10909,42152,53061
http://156.56.83.24:6003/25kb,26065,1,6436,13592,39933,53525
http://156.56.83.24:6003/25kb,26065,1,6436,8325,39289,47614
http://156.56.83.24:6003/25kb,26065,1,6436,9864,37471,47335
http://156.56.83.24:6003/25kb,26065,1,6436,9945,44061,54006
http://156.56.83.24:6003/25kb,26065,1,6436,29909,47488,77397
http://156.56.83.24:6003/25kb,26065,1,6436,13880,62454,76334
http://156.56.83.24:6003/25kb,26065,1,6436,13459,55260,68719
http://156.56.83.24:6003/25kb,26065,1,6436,12636,34653,47289
http://156.56.83.24:6003/25kb,26065,1,6436,8380,39641,48021
http://156.56.83.24:6003/25kb,26065,1,6436,9526,38159,47685
http://156.56.83.24:6003/25kb,26065,1,6436,11720,42085,53805
http://156.56.83.24:6003/25kb,26065,1,6436,9385,42593,51978
http://156.56.83.24:6003/25kb,26065,1,6436,11652,31010,42662
http://156.56.83.24:6003/25kb,26065,1,6436,16629,37041,53670
http://156.56.83.24:6003/25kb,26065,1,6436,12817,32470,45287
http://156.56.83.24:6003/25kb,26065,1,6436,9381,43083,52464
http://156.56.83.24:6003/25kb,26065,1,6436,13207,45815,59022
http://156.56.83.24:6003/25kb,26065,1,6436,10383,36116,46499
http://156.56.83.24:6003/25kb,26065,1,6436,9807,39989,49796
http://156.56.83.24:6003/25kb,26065,1,6436,10384,38902,49286
http://156.56.83.24:6003/25kb,26065,1,6436,12910,31201,44111
http://156.56.83.24:6003/25kb,26065,1,6436,13201,42972,56173
http://156.56.83.24:6003/25kb,26065,1,6436,12985,44955,57940
http://156.56.83.24:6003/25kb,26065,1,6436,12896,49645,62541
http://156.56.83.24:6003/25kb,26065,1,6436,13063,52081,65144
http://156.56.83.24:6003/25kb,26065,1,6436,18336,45526,63862
http://156.56.83.24:6003/25kb,26065,1,6436,15296,61684,76980
http://156.56.83.24:6003/25kb,26065,1,6436,13350,63556,76906
http://156.56.83.24:6003/25kb,26065,1,6436,12009,54852,66861
http://156.56.83.24:6003/25kb,26065,1,6436,14590,39910,54500
http://156.56.83.24:6003/25kb,26065,1,6436,12682,48883,61565
http://156.56.83.24:6003/25kb,26065,1,6436,11408,48307,59715
http://156.56.83.24:6003/25kb,26065,1,6436,18019,49796,67815
http://156.56.83.24:6003/25kb,26065,1,6436,16280,42932,59212
http://156.56.83.24:6003/25kb,26065,1,6436,13832,39606,53438
http://156.56.83.24:6003/25kb,26065,1,6436,9264,40306,49570
http://156.56.83.24:6003/25kb,26065,1,6436,12766,38685,51451
http://156.56.83.24:6003/25kb,26065,1,6436,12258,56869,69127
http://156.56.83.24:6003/25kb,26065,1,6436,11681,289506,301187
http://156.56.83.24:6003/25kb,26065,1,6436,6061,52317,58378
http://156.56.83.24:6003/25kb,26065,1,6436,8623,43956,52579
http://156.56.83.24:6003/25kb,26065,1,6436,11309,45378,56687
http://156.56.83.24:6003/25kb,26065,1,6436,12518,44013,56531
http://156.56.83.24:6003/25kb,26065,1,6436,15414,48440,63854
http://156.56.83.24:6003/25kb,26065,1,6436,16765,35047,51812
http://156.56.83.24:6003/25kb,26065,1,6436,15282,51581,66863
http://156.56.83.24:6003/25kb,26065,1,6436,17899,40385,58284
http://156.56.83.24:6003/25kb,26065,1,6436,10325,44320,54645
http://156.56.83.24:6003/25kb,26065,1,6436,11998,45159,57157
http://156.56.83.24:6003/25kb,26065,1,6436,7165,37765,44930
http://156.56.83.24:6003/25kb,26065,1,6436,10074,30571,40645
http://156.56.83.24:6003/25kb,26065,1,6436,7853,33659,41512
http://156.56.83.24:6003/25kb,26065,1,6436,11829,26458,38287
http://156.56.83.24:6003/25kb,26065,1,6436,13997,32269,46266
http://156.56.83.24:6003/25kb,26065,1,6436,11198,29992,41190
http://156.56.83.24:6003/25kb,26065,1,6436,14523,30571,45094
http://156.56.83.24:6003/25kb,26065,1,6436,12692,30889,43581
http://156.56.83.24:6003/25kb,26065,1,6436,11185,32682,43867
http://156.56.83.24:6003/25kb,26065,1,6436,11196,32680,43876
http://156.56.83.24:6003/25kb,26065,1,6436,12672,32859,45531
http://156.56.83.24:6003/25kb,26065,1,6436,10638,30715,41353
http://156.56.83.24:6003/25kb,26065,1,6436,10206,29756,39962
http://156.56.83.24:6003/25kb,26065,1,6436,10806,36957,47763
http://156.56.83.24:6003/25kb,26065,1,6436,13167,42558,55725
http://156.56.83.24:6003/25kb,26065,1,6436,12965,37424,50389
http://156.56.83.24:6003/25kb,26065,1,6436,9733,50271,60004
http://156.56.83.24:6003/25kb,26065,1,6436,6715,37053,43768
http://156.56.83.24:6003/25kb,26065,1,6436,9164,36324,45488
http://156.56.83.24:6003/25kb,26065,1,6436,8373,39044,47417
http://156.56.83.24:6003/25kb,26065,1,6436,12533,37974,50507
http://156.56.83.24:6003/25kb,26065,1,6436,12793,45961,58754
http://156.56.83.24:6003/25kb,26065,1,6436,9497,27351,36848
http://156.56.83.24:6003/25kb,26065,1,6436,11114,31216,42330
http://156.56.83.24:6003/25kb,26065,1,6436,9686,29865,39551
http://156.56.83.24:6003/25kb,26065,1,6436,12576,32090,44666
http://156.56.83.24:6003/25kb,26065,1,6436,11123,38085,49208
http://156.56.83.24:6003/25kb,26065,1,6436,12228,83909,96137
http://156.56.83.24:6003/25kb,26065,1,6436,11746,42450,54196
http://156.56.83.24:6003/25kb,26065,1,6436,12714,45598,58312
http://156.56.83.24:6003/25kb,26065,1,6436,32986,54401,87387
http://156.56.83.24:6003/25kb,26065,1,6436,15784,68335,84119
http://156.56.83.24:6003/25kb,26065,1,6436,16169,56641,72810
http://156.56.83.24:6003/25kb,26065,1,6436,13583,43920,57503
http://156.56.83.24:6003/25kb,26065,1,6436,12622,40126,52748
http://156.56.83.24:6003/25kb,26065,1,6436,10430,45057,55487
http://156.56.83.24:6003/25kb,26065,1,6436,8902,48137,57039
http://156.56.83.24:6003/25kb,26065,1,6436,9934,33493,43427
http://156.56.83.24:6003/25kb,26065,1,6436,8739,28929,37668
http://156.56.83.24:6003/25kb,26065,1,6436,10568,29740,40308
http://156.56.83.24:6003/25kb,26065,1,6436,12452,31474,43926
http://156.56.83.24:6003/25kb,26065,1,6436,9935,35004,44939
http://156.56.83.24:6003/25kb,26065,1,6436,15019,31064,46083
http://156.56.83.24:6003/25kb,26065,1,6436,11050,35162,46212
http://156.56.83.24:6003/25kb,26065,1,6436,14149,43821,57970
http://156.56.83.24:6003/25kb,26065,1,6436,15809,50343,66152
http://156.56.83.24:6003/25kb,26065,1,6436,14749,42670,57419
http://156.56.83.24:6003/25kb,26065,1,6436,11935,43498,55433
http://156.56.83.24:6003/25kb,26065,1,6436,5646,40379,46025
http://156.56.83.24:6003/25kb,26065,1,6436,7033,30387,37420
http://156.56.83.24:6003/25kb,26065,1,6436,7886,36641,44527
http://156.56.83.24:6003/25kb,26065,1,6436,11008,47202,58210
http://156.56.83.24:6003/25kb,26065,1,6436,10890,44784,55674
http://156.56.83.24:6003/25kb,26065,1,6436,9061,57959,67020
http://156.56.83.24:6003/25kb,26065,1,6436,13327,71552,84879
http://156.56.83.24:6003/25kb,26065,1,6436,15528,62708,78236
http://156.56.83.24:6003/25kb,26065,1,6436,12475,57996,70471
http://156.56.83.24:6003/25kb,26065,1,6436,10793,36724,47517
http://156.56.83.24:6003/25kb,26065,1,6436,4668,40754,45422
http://156.56.83.24:6003/25kb,26065,1,6436,6998,38152,45150
http://156.56.83.24:6003/25kb,26065,1,6436,11647,32466,44113
http://156.56.83.24:6003/25kb,26065,1,6436,6752,22606,29358
http://156.56.83.24:6003/25kb,26065,1,6436,8560,29100,37660
http://156.56.83.24:6003/25kb,26065,1,6436,6157,26729,32886
http://156.56.83.24:6003/25kb,26065,1,6436,10267,257084,267351
http://156.56.83.24:6003/25kb,26065,1,6436,13376,41164,54540
http://156.56.83.24:6003/25kb,26065,1,6436,14517,45796,60313
http://156.56.83.24:6003/25kb,26065,1,6436,16437,48817,65254
http://156.56.83.24:6003/25kb,26065,1,6436,18239,44819,63058
http://156.56.83.24:6003/25kb,26065,1,6436,14143,49070,63213
