http://156.56.83.24:6003/2500kb,2520350,2,6406,6244,3643310,3649554
http://156.56.83.24:6003/2500kb,2520350,2,6406,11028,3295491,3306519
http://156.56.83.24:6003/2500kb,2520350,2,6406,4510,3608782,3613292
http://156.56.83.24:6003/2500kb,2520350,2,6406,9165,2385235,2394400
http://156.56.83.24:6003/2500kb,2520350,2,6406,5816,2121708,2127524
http://156.56.83.24:6003/2500kb,2520350,2,6406,4926,2129019,2133945
http://156.56.83.24:6003/2500kb,2520350,2,6406,4539,2147366,2151905
http://156.56.83.24:6003/2500kb,2520350,2,6406,4195,2140726,2144921
http://156.56.83.24:6003/2500kb,2520350,2,6406,16372,2122336,2138708
http://156.56.83.24:6003/2500kb,2520350,2,6406,2759,2130491,2133250
http://156.56.83.24:6003/2500kb,2520350,2,6406,3657,2129725,2133382
http://156.56.83.24:6003/2500kb,2520350,2,6406,3548,2136566,2140114
http://156.56.83.24:6003/2500kb,2520350,2,6406,2798,2138500,2141298
http://156.56.83.24:6003/2500kb,2520350,2,6406,4665,2114377,2119042
http://156.56.83.24:6003/2500kb,2520350,2,6406,2208,2140969,2143177
http://156.56.83.24:6003/2500kb,2520350,2,6406,2905,2125953,2128858
http://156.56.83.24:6003/2500kb,2520350,2,6406,5478,2116500,2121978
http://156.56.83.24:6003/2500kb,2520350,2,6406,2993,2123498,2126491
http://156.56.83.24:6003/2500kb,2520350,2,6406,3076,2117179,2120255
http://156.56.83.24:6003/2500kb,2520350,2,6406,4176,2158767,2162943
http://156.56.83.24:6003/2500kb,2520350,2,6406,4379,2116051,2120430
http://156.56.83.24:6003/2500kb,2520350,2,6406,3414,2131088,2134502
http://156.56.83.24:6003/2500kb,2520350,2,6406,3688,2125742,2129430
http://156.56.83.24:6003/2500kb,2520350,2,6406,4958,2127372,2132330
http://156.56.83.24:6003/2500kb,2520350,2,6406,3069,2137617,2140686
http://156.56.83.24:6003/2500kb,2520350,2,6406,3691,2132530,2136221
http://156.56.83.24:6003/2500kb,2520350,2,6406,4686,2130339,2135025
http://156.56.83.24:6003/2500kb,2520350,2,6406,3199,2128854,2132053
http://156.56.83.24:6003/2500kb,2520350,2,6406,4425,2127092,2131517
http://156.56.83.24:6003/2500kb,2520350,2,6406,2658,2140791,2143449
http://156.56.83.24:6003/2500kb,2520350,2,6406,4704,2120710,2125414
http://156.56.83.24:6003/2500kb,2520350,2,6406,4718,2117473,2122191
http://156.56.83.24:6003/2500kb,2520350,2,6406,3169,2128303,2131472
http://156.56.83.24:6003/2500kb,2520350,2,6406,1891,2116799,2118690
http://156.56.83.24:6003/2500kb,2520350,2,6406,5845,2122019,2127864
http://156.56.83.24:6003/2500kb,2520350,2,6406,5920,2114162,2120082
http://156.56.83.24:6003/2500kb,2520350,2,6406,2088,2135906,2137994
http://156.56.83.24:6003/2500kb,2520350,2,6406,5052,2121805,2126857
http://156.56.83.24:6003/2500kb,2520350,2,6406,2110,2127774,2129884
http://156.56.83.24:6003/2500kb,2520350,2,6406,5497,2113624,2119121
http://156.56.83.24:6003/2500kb,2520350,2,6406,3082,2128495,2131577
http://156.56.83.24:6003/2500kb,2520350,2,6406,1850,2137660,2139510
http://156.56.83.24:6003/2500kb,2520350,2,6406,3362,2125050,2128412
http://156.56.83.24:6003/2500kb,2520350,2,6406,2522,2119514,2122036
http://156.56.83.24:6003/2500kb,2520350,2,6406,4482,2117746,2122228
http://156.56.83.24:6003/2500kb,2520350,2,6406,5322,2122879,2128201
http://156.56.83.24:6003/2500kb,2520350,2,6406,3565,2137801,2141366
http://156.56.83.24:6003/2500kb,2520350,2,6406,3589,2121619,2125208
http://156.56.83.24:6003/2500kb,2520350,2,6406,1768,2133461,2135229
http://156.56.83.24:6003/2500kb,2520350,2,6406,3768,2130743,2134511
http://156.56.83.24:6003/2500kb,2520350,2,6406,2281,2126557,2128838
http://156.56.83.24:6003/2500kb,2520350,2,6406,2045,2128250,2130295
http://156.56.83.24:6003/2500kb,2520350,2,6406,4079,2132379,2136458
http://156.56.83.24:6003/2500kb,2520350,2,6406,3908,2127357,2131265
http://156.56.83.24:6003/2500kb,2520350,2,6406,5577,2131962,2137539
http://156.56.83.24:6003/2500kb,2520350,2,6406,5099,2115248,2120347
http://156.56.83.24:6003/2500kb,2520350,2,6406,1871,2134804,2136675
http://156.56.83.24:6003/2500kb,2520350,2,6406,16814,2126494,2143308
http://156.56.83.24:6003/2500kb,2520350,2,6406,4622,2138629,2143251
http://156.56.83.24:6003/2500kb,2520350,2,6406,5277,2128721,2133998
http://156.56.83.24:6003/2500kb,2520350,2,6406,4349,2128595,2132944
http://156.56.83.24:6003/2500kb,2520350,2,6406,2745,2129106,2131851
http://156.56.83.24:6003/2500kb,2520350,2,6406,3510,2136281,2139791
http://156.56.83.24:6003/2500kb,2520350,2,6406,4621,2128989,2133610
http://156.56.83.24:6003/2500kb,2520350,2,6406,4029,2129184,2133213
http://156.56.83.24:6003/2500kb,2520350,2,6406,2123,2142516,2144639
http://156.56.83.24:6003/2500kb,2520350,2,6406,2137,2139875,2142012
http://156.56.83.24:6003/2500kb,2520350,2,6406,4756,2124242,2128998
http://156.56.83.24:6003/2500kb,2520350,2,6406,4315,2166692,2171007
http://156.56.83.24:6003/2500kb,2520350,2,6406,4697,2132879,2137576
http://156.56.83.24:6003/2500kb,2520350,2,6406,3388,2124487,2127875
http://156.56.83.24:6003/2500kb,2520350,2,6406,3313,2119965,2123278
http://156.56.83.24:6003/2500kb,2520350,2,6406,2804,2127477,2130281
http://156.56.83.24:6003/2500kb,2520350,2,6406,3843,2121116,2124959
http://156.56.83.24:6003/2500kb,2520350,2,6406,5533,2130934,2136467
http://156.56.83.24:6003/2500kb,2520350,2,6406,4627,2137616,2142243
http://156.56.83.24:6003/2500kb,2520350,2,6406,4821,2132102,2136923
http://156.56.83.24:6003/2500kb,2520350,2,6406,4215,2159518,2163733
http://156.56.83.24:6003/2500kb,2520350,2,6406,5021,2131041,2136062
http://156.56.83.24:6003/2500kb,2520350,2,6406,4799,2129976,2134775
http://156.56.83.24:6003/2500kb,2520350,2,6406,1707,2145182,2146889
http://156.56.83.24:6003/2500kb,2520350,2,6406,5223,2135889,2141112
http://156.56.83.24:6003/2500kb,2520350,2,6406,4587,2131069,2135656
http://156.56.83.24:6003/2500kb,2520350,2,6406,5000,2128020,2133020
http://156.56.83.24:6003/2500kb,2520350,2,6406,3849,2122483,2126332
http://156.56.83.24:6003/2500kb,2520350,2,6406,5586,2124503,2130089
http://156.56.83.24:6003/2500kb,2520350,2,6406,3132,2120857,2123989
http://156.56.83.24:6003/2500kb,2520350,2,6406,6018,2115919,2121937
http://156.56.83.24:6003/2500kb,2520350,2,6406,2742,2115131,2117873
http://156.56.83.24:6003/2500kb,2520350,2,6406,1836,2121678,2123514
http://156.56.83.24:6003/2500kb,2520350,2,6406,2257,2112813,2115070
http://156.56.83.24:6003/2500kb,2520350,2,6406,2223,2120383,2122606
http://156.56.83.24:6003/2500kb,2520350,2,6406,1753,2120017,2121770
http://156.56.83.24:6003/2500kb,2520350,2,6406,2979,2118836,2121815
http://156.56.83.24:6003/2500kb,2520350,2,6406,4624,2132870,2137494
http://156.56.83.24:6003/2500kb,2520350,2,6406,2190,2126120,2128310
http://156.56.83.24:6003/2500kb,2520350,2,6406,4418,2122684,2127102
http://156.56.83.24:6003/2500kb,2520350,2,6406,3548,2146847,2150395
http://156.56.83.24:6003/2500kb,2520350,2,6406,6183,2135515,2141698
http://156.56.83.24:6003/2500kb,2520350,2,6406,4303,2134505,2138808
http://156.56.83.24:6003/2500kb,2520350,2,6406,2440,2138070,2140510
http://156.56.83.24:6003/2500kb,2520350,2,6406,4933,2129947,2134880
http://156.56.83.24:6003/2500kb,2520350,2,6406,2604,2125319,2127923
http://156.56.83.24:6003/2500kb,2520350,2,6406,3884,2130851,2134735
http://156.56.83.24:6003/2500kb,2520350,2,6406,3046,2155029,2158075
http://156.56.83.24:6003/2500kb,2520350,2,6406,3746,2130583,2134329
http://156.56.83.24:6003/2500kb,2520350,2,6406,2859,2133304,2136163
http://156.56.83.24:6003/2500kb,2520350,2,6406,4196,2133724,2137920
http://156.56.83.24:6003/2500kb,2520350,2,6406,3330,2130850,2134180
http://156.56.83.24:6003/2500kb,2520350,2,6406,4237,2121408,2125645
http://156.56.83.24:6003/2500kb,2520350,2,6406,5981,2140060,2146041
http://156.56.83.24:6003/2500kb,2520350,2,6406,5174,2125169,2130343
http://156.56.83.24:6003/2500kb,2520350,2,6406,4020,2140388,2144408
http://156.56.83.24:6003/2500kb,2520350,2,6406,5042,2116826,2121868
http://156.56.83.24:6003/2500kb,2520350,2,6406,3797,2130481,2134278
http://156.56.83.24:6003/2500kb,2520350,2,6406,3149,2126503,2129652
http://156.56.83.24:6003/2500kb,2520350,2,6406,1944,2144309,2146253
http://156.56.83.24:6003/2500kb,2520350,2,6406,2658,2128150,2130808
http://156.56.83.24:6003/2500kb,2520350,2,6406,3635,2129348,2132983
http://156.56.83.24:6003/2500kb,2520350,2,6406,4763,2124335,2129098
http://156.56.83.24:6003/2500kb,2520350,2,6406,5295,2114042,2119337
http://156.56.83.24:6003/2500kb,2520350,2,6406,3177,2125531,2128708
http://156.56.83.24:6003/2500kb,2520350,2,6406,4132,2119337,2123469
http://156.56.83.24:6003/2500kb,2520350,2,6406,5134,2123372,2128506
http://156.56.83.24:6003/2500kb,2520350,2,6406,2135,2124353,2126488
http://156.56.83.24:6003/2500kb,2520350,2,6406,3784,2117603,2121387
http://156.56.83.24:6003/2500kb,2520350,2,6406,5638,2133279,2138917
http://156.56.83.24:6003/2500kb,2520350,2,6406,3417,2139854,2143271
http://156.56.83.24:6003/2500kb,2520350,2,6406,2507,2131128,2133635
http://156.56.83.24:6003/2500kb,2520350,2,6406,6025,2143544,2149569
http://156.56.83.24:6003/2500kb,2520350,2,6406,3367,2129661,2133028
http://156.56.83.24:6003/2500kb,2520350,2,6406,2710,2130831,2133541
http://156.56.83.24:6003/2500kb,2520350,2,6406,5448,2137794,2143242
http://156.56.83.24:6003/2500kb,2520350,2,6406,3484,2121456,2124940
http://156.56.83.24:6003/2500kb,2520350,2,6406,5700,2124726,2130426
http://156.56.83.24:6003/2500kb,2520350,2,6406,2572,2125855,2128427
http://156.56.83.24:6003/2500kb,2520350,2,6406,3179,2128291,2131470
http://156.56.83.24:6003/2500kb,2520350,2,6406,3503,2123267,2126770
http://156.56.83.24:6003/2500kb,2520350,2,6406,3394,2131884,2135278
http://156.56.83.24:6003/2500kb,2520350,2,6406,2379,2133878,2136257
http://156.56.83.24:6003/2500kb,2520350,2,6406,4956,2122581,2127537
http://156.56.83.24:6003/2500kb,2520350,2,6406,5648,2130309,2135957
http://156.56.83.24:6003/2500kb,2520350,2,6406,5449,2118661,2124110
http://156.56.83.24:6003/2500kb,2520350,2,6406,3623,2108173,2111796
http://156.56.83.24:6003/2500kb,2520350,2,6406,3209,2130078,2133287
http://156.56.83.24:6003/2500kb,2520350,2,6406,2139,2134368,2136507
http://156.56.83.24:6003/2500kb,2520350,2,6406,2133,2125714,2127847
http://156.56.83.24:6003/2500kb,2520350,2,6406,4060,2115479,2119539
http://156.56.83.24:6003/2500kb,2520350,2,6406,4914,2126263,2131177
http://156.56.83.24:6003/2500kb,2520350,2,6406,5619,2115386,2121005
http://156.56.83.24:6003/2500kb,2520350,2,6406,1883,2115346,2117229
http://156.56.83.24:6003/2500kb,2520350,2,6406,5117,2125744,2130861
http://156.56.83.24:6003/2500kb,2520350,2,6406,6089,2125646,2131735
http://156.56.83.24:6003/2500kb,2520350,2,6406,1995,2136846,2138841
http://156.56.83.24:6003/2500kb,2520350,2,6406,3716,2117947,2121663
http://156.56.83.24:6003/2500kb,2520350,2,6406,5982,2114842,2120824
http://156.56.83.24:6003/2500kb,2520350,2,6406,4505,2112050,2116555
http://156.56.83.24:6003/2500kb,2520350,2,6406,3166,2114525,2117691
http://156.56.83.24:6003/2500kb,2520350,2,6406,2590,2125342,2127932
http://156.56.83.24:6003/2500kb,2520350,2,6406,3934,2125889,2129823
http://156.56.83.24:6003/2500kb,2520350,2,6406,3974,2137906,2141880
http://156.56.83.24:6003/2500kb,2520350,2,6406,1978,2118435,2120413
http://156.56.83.24:6003/2500kb,2520350,2,6406,2119,2122946,2125065
http://156.56.83.24:6003/2500kb,2520350,2,6406,4376,2126625,2131001
http://156.56.83.24:6003/2500kb,2520350,2,6406,3881,2127026,2130907
http://156.56.83.24:6003/2500kb,2520350,2,6406,5625,2129895,2135520
http://156.56.83.24:6003/2500kb,2520350,2,6406,3258,2149900,2153158
http://156.56.83.24:6003/2500kb,2520350,2,6406,2939,2133354,2136293
http://156.56.83.24:6003/2500kb,2520350,2,6406,4588,2127229,2131817
http://156.56.83.24:6003/2500kb,2520350,2,6406,5259,2125956,2131215
http://156.56.83.24:6003/2500kb,2520350,2,6406,2916,2118523,2121439
http://156.56.83.24:6003/2500kb,2520350,2,6406,5139,2132461,2137600
http://156.56.83.24:6003/2500kb,2520350,2,6406,2864,2121429,2124293
http://156.56.83.24:6003/2500kb,2520350,2,6406,2824,2124780,2127604
http://156.56.83.24:6003/2500kb,2520350,2,6406,4822,2136552,2141374
http://156.56.83.24:6003/2500kb,2520350,2,6406,2428,2128237,2130665
http://156.56.83.24:6003/2500kb,2520350,2,6406,2855,2138364,2141219
http://156.56.83.24:6003/2500kb,2520350,2,6406,3822,2125779,2129601
http://156.56.83.24:6003/2500kb,2520350,2,6406,1771,2133367,2135138
http://156.56.83.24:6003/2500kb,2520350,2,6406,2707,2129460,2132167
http://156.56.83.24:6003/2500kb,2520350,2,6406,1900,2139345,2141245
http://156.56.83.24:6003/2500kb,2520350,2,6406,4182,2113932,2118114
http://156.56.83.24:6003/2500kb,2520350,2,6406,3308,2113374,2116682
http://156.56.83.24:6003/2500kb,2520350,2,6406,3890,2129682,2133572
http://156.56.83.24:6003/2500kb,2520350,2,6406,3573,2128909,2132482
http://156.56.83.24:6003/2500kb,2520350,2,6406,2635,2124658,2127293
http://156.56.83.24:6003/2500kb,2520350,2,6406,5257,2127439,2132696
http://156.56.83.24:6003/2500kb,2520350,2,6406,1828,2117116,2118944
http://156.56.83.24:6003/2500kb,2520350,2,6406,2592,2127633,2130225
http://156.56.83.24:6003/2500kb,2520350,2,6406,2808,2113825,2116633
http://156.56.83.24:6003/2500kb,2520350,2,6406,4604,2151198,2155802
http://156.56.83.24:6003/2500kb,2520350,2,6406,5227,2117332,2122559
http://156.56.83.24:6003/2500kb,2520350,2,6406,5187,2122822,2128009
http://156.56.83.24:6003/2500kb,2520350,2,6406,1613,2125308,2126921
http://156.56.83.24:6003/2500kb,2520350,2,6406,2000,2142824,2144824
http://156.56.83.24:6003/2500kb,2520350,2,6406,3780,2127490,2131270
http://156.56.83.24:6003/2500kb,2520350,2,6406,5987,2139624,2145611
http://156.56.83.24:6003/2500kb,2520350,2,6406,4626,2136702,2141328
http://156.56.83.24:6003/2500kb,2520350,2,6406,4297,2120545,2124842
http://156.56.83.24:6003/2500kb,2520350,2,6406,2831,2135471,2138302
