http://156.56.83.24:6003/2500kb,2520350,2,4857,5507,824990,830497
http://156.56.83.24:6003/2500kb,2520350,2,4857,2932,614029,616961
http://156.56.83.24:6003/2500kb,2520350,2,4857,2162,612833,614995
http://156.56.83.24:6003/2500kb,2520350,2,4857,5642,670959,676601
http://156.56.83.24:6003/2500kb,2520350,2,4857,2325,743711,746036
http://156.56.83.24:6003/2500kb,2520350,2,4857,2960,609374,612334
http://156.56.83.24:6003/2500kb,2520350,2,4857,2834,546126,548960
http://156.56.83.24:6003/2500kb,2520350,2,4857,2509,534007,536516
http://156.56.83.24:6003/2500kb,2520350,2,4857,4515,597695,602210
http://156.56.83.24:6003/2500kb,2520350,2,4857,4241,600731,604972
http://156.56.83.24:6003/2500kb,2520350,2,4857,3402,548170,551572
http://156.56.83.24:6003/2500kb,2520350,2,4857,2996,623612,626608
http://156.56.83.24:6003/2500kb,2520350,2,4857,5719,605088,610807
http://156.56.83.24:6003/2500kb,2520350,2,4857,4751,661327,666078
http://156.56.83.24:6003/2500kb,2520350,2,4857,2221,697104,699325
http://156.56.83.24:6003/2500kb,2520350,2,4857,2220,648913,651133
http://156.56.83.24:6003/2500kb,2520350,2,4857,5411,674135,679546
http://156.56.83.24:6003/2500kb,2520350,2,4857,2360,549426,551786
http://156.56.83.24:6003/2500kb,2520350,2,4857,5043,536608,541651
http://156.56.83.24:6003/2500kb,2520350,2,4857,4932,573215,578147
http://156.56.83.24:6003/2500kb,2520350,2,4857,3821,550110,553931
http://156.56.83.24:6003/2500kb,2520350,2,4857,3530,579670,583200
http://156.56.83.24:6003/2500kb,2520350,2,4857,4504,643660,648164
http://156.56.83.24:6003/2500kb,2520350,2,4857,5783,588714,594497
http://156.56.83.24:6003/2500kb,2520350,2,4857,4083,576520,580603
http://156.56.83.24:6003/2500kb,2520350,2,4857,2552,585823,588375
http://156.56.83.24:6003/2500kb,2520350,2,4857,1519,539642,541161
http://156.56.83.24:6003/2500kb,2520350,2,4857,2498,576534,579032
http://156.56.83.24:6003/2500kb,2520350,2,4857,2641,505611,508252
http://156.56.83.24:6003/2500kb,2520350,2,4857,2653,585380,588033
http://156.56.83.24:6003/2500kb,2520350,2,4857,4649,563753,568402
http://156.56.83.24:6003/2500kb,2520350,2,4857,3413,574458,577871
http://156.56.83.24:6003/2500kb,2520350,2,4857,4251,577910,582161
http://156.56.83.24:6003/2500kb,2520350,2,4857,1724,511228,512952
http://156.56.83.24:6003/2500kb,2520350,2,4857,5759,524790,530549
http://156.56.83.24:6003/2500kb,2520350,2,4857,1839,520276,522115
http://156.56.83.24:6003/2500kb,2520350,2,4857,2020,536588,538608
http://156.56.83.24:6003/2500kb,2520350,2,4857,11573,623069,634642
http://156.56.83.24:6003/2500kb,2520350,2,4857,2646,575139,577785
http://156.56.83.24:6003/2500kb,2520350,2,4857,3857,521702,525559
http://156.56.83.24:6003/2500kb,2520350,2,4857,4142,595060,599202
http://156.56.83.24:6003/2500kb,2520350,2,4857,2632,547542,550174
http://156.56.83.24:6003/2500kb,2520350,2,4857,3560,531511,535071
http://156.56.83.24:6003/2500kb,2520350,2,4857,1931,509451,511382
http://156.56.83.24:6003/2500kb,2520350,2,4857,3909,543260,547169
http://156.56.83.24:6003/2500kb,2520350,2,4857,4629,573943,578572
http://156.56.83.24:6003/2500kb,2520350,2,4857,5758,621533,627291
http://156.56.83.24:6003/2500kb,2520350,2,4857,2990,624301,627291
http://156.56.83.24:6003/2500kb,2520350,2,4857,3589,613781,617370
http://156.56.83.24:6003/2500kb,2520350,2,4857,11637,568115,579752
http://156.56.83.24:6003/2500kb,2520350,2,4857,2187,554288,556475
http://156.56.83.24:6003/2500kb,2520350,2,4857,3374,583481,586855
http://156.56.83.24:6003/2500kb,2520350,2,4857,5011,540729,545740
http://156.56.83.24:6003/2500kb,2520350,2,4857,5176,589914,595090
http://156.56.83.24:6003/2500kb,2520350,2,4857,2561,559036,561597
http://156.56.83.24:6003/2500kb,2520350,2,4857,3754,530980,534734
http://156.56.83.24:6003/2500kb,2520350,2,4857,4720,551088,555808
http://156.56.83.24:6003/2500kb,2520350,2,4857,3166,517590,520756
http://156.56.83.24:6003/2500kb,2520350,2,4857,3793,576605,580398
http://156.56.83.24:6003/2500kb,2520350,2,4857,3360,575772,579132
http://156.56.83.24:6003/2500kb,2520350,2,4857,4144,520126,524270
http://156.56.83.24:6003/2500kb,2520350,2,4857,2932,523271,526203
http://156.56.83.24:6003/2500kb,2520350,2,4857,3571,518806,522377
http://156.56.83.24:6003/2500kb,2520350,2,4857,5259,633430,638689
http://156.56.83.24:6003/2500kb,2520350,2,4857,2675,586106,588781
http://156.56.83.24:6003/2500kb,2520350,2,4857,2646,546999,549645
http://156.56.83.24:6003/2500kb,2520350,2,4857,1974,503216,505190
http://156.56.83.24:6003/2500kb,2520350,2,4857,6103,485254,491357
http://156.56.83.24:6003/2500kb,2520350,2,4857,4252,479627,483879
http://156.56.83.24:6003/2500kb,2520350,2,4857,4870,417548,422418
http://156.56.83.24:6003/2500kb,2520350,2,4857,2976,473451,476427
http://156.56.83.24:6003/2500kb,2520350,2,4857,4464,544935,549399
http://156.56.83.24:6003/2500kb,2520350,2,4857,4597,541236,545833
http://156.56.83.24:6003/2500kb,2520350,2,4857,5511,615969,621480
http://156.56.83.24:6003/2500kb,2520350,2,4857,2003,511139,513142
http://156.56.83.24:6003/2500kb,2520350,2,4857,4988,476990,481978
http://156.56.83.24:6003/2500kb,2520350,2,4857,2145,486870,489015
http://156.56.83.24:6003/2500kb,2520350,2,4857,2000,472165,474165
http://156.56.83.24:6003/2500kb,2520350,2,4857,4400,506277,510677
http://156.56.83.24:6003/2500kb,2520350,2,4857,3442,470784,474226
http://156.56.83.24:6003/2500kb,2520350,2,4857,5567,503896,509463
http://156.56.83.24:6003/2500kb,2520350,2,4857,2924,584318,587242
http://156.56.83.24:6003/2500kb,2520350,2,4857,3625,576968,580593
http://156.56.83.24:6003/2500kb,2520350,2,4857,6074,565906,571980
http://156.56.83.24:6003/2500kb,2520350,2,4857,3603,491172,494775
http://156.56.83.24:6003/2500kb,2520350,2,4857,3597,540152,543749
http://156.56.83.24:6003/2500kb,2520350,2,4857,2589,423625,426214
http://156.56.83.24:6003/2500kb,2520350,2,4857,4908,561774,566682
http://156.56.83.24:6003/2500kb,2520350,2,4857,3531,659409,662940
http://156.56.83.24:6003/2500kb,2520350,2,4857,4438,569194,573632
http://156.56.83.24:6003/2500kb,2520350,2,4857,2071,637866,639937
http://156.56.83.24:6003/2500kb,2520350,2,4857,4089,547123,551212
http://156.56.83.24:6003/2500kb,2520350,2,4857,5176,496315,501491
http://156.56.83.24:6003/2500kb,2520350,2,4857,2721,490146,492867
http://156.56.83.24:6003/2500kb,2520350,2,4857,2141,528415,530556
http://156.56.83.24:6003/2500kb,2520350,2,4857,2172,574510,576682
http://156.56.83.24:6003/2500kb,2520350,2,4857,3737,711647,715384
http://156.56.83.24:6003/2500kb,2520350,2,4857,3510,763423,766933
http://156.56.83.24:6003/2500kb,2520350,2,4857,3944,640451,644395
http://156.56.83.24:6003/2500kb,2520350,2,4857,2892,591831,594723
http://156.56.83.24:6003/2500kb,2520350,2,4857,2514,670864,673378
http://156.56.83.24:6003/2500kb,2520350,2,4857,4482,723276,727758
http://156.56.83.24:6003/2500kb,2520350,2,4857,4804,628171,632975
http://156.56.83.24:6003/2500kb,2520350,2,4857,5796,602915,608711
http://156.56.83.24:6003/2500kb,2520350,2,4857,3268,561769,565037
http://156.56.83.24:6003/2500kb,2520350,2,4857,5460,673371,678831
http://156.56.83.24:6003/2500kb,2520350,2,4857,4175,722806,726981
http://156.56.83.24:6003/2500kb,2520350,2,4857,5287,619593,624880
http://156.56.83.24:6003/2500kb,2520350,2,4857,2947,710400,713347
http://156.56.83.24:6003/2500kb,2520350,2,4857,2097,662124,664221
http://156.56.83.24:6003/2500kb,2520350,2,4857,4634,605485,610119
http://156.56.83.24:6003/2500kb,2520350,2,4857,2180,529017,531197
http://156.56.83.24:6003/2500kb,2520350,2,4857,1733,545001,546734
http://156.56.83.24:6003/2500kb,2520350,2,4857,3615,634601,638216
http://156.56.83.24:6003/2500kb,2520350,2,4857,1865,743204,745069
http://156.56.83.24:6003/2500kb,2520350,2,4857,3574,590865,594439
http://156.56.83.24:6003/2500kb,2520350,2,4857,2985,496958,499943
http://156.56.83.24:6003/2500kb,2520350,2,4857,4235,527083,531318
http://156.56.83.24:6003/2500kb,2520350,2,4857,11787,554921,566708
http://156.56.83.24:6003/2500kb,2520350,2,4857,3528,524005,527533
http://156.56.83.24:6003/2500kb,2520350,2,4857,4113,680824,684937
http://156.56.83.24:6003/2500kb,2520350,2,4857,5134,780234,785368
http://156.56.83.24:6003/2500kb,2520350,2,4857,1942,500529,502471
http://156.56.83.24:6003/2500kb,2520350,2,4857,6158,569766,575924
http://156.56.83.24:6003/2500kb,2520350,2,4857,5114,616711,621825
http://156.56.83.24:6003/2500kb,2520350,2,4857,5281,673264,678545
http://156.56.83.24:6003/2500kb,2520350,2,4857,3668,624927,628595
http://156.56.83.24:6003/2500kb,2520350,2,4857,5419,652486,657905
http://156.56.83.24:6003/2500kb,2520350,2,4857,5854,667502,673356
http://156.56.83.24:6003/2500kb,2520350,2,4857,5772,660185,665957
http://156.56.83.24:6003/2500kb,2520350,2,4857,4899,559782,564681
http://156.56.83.24:6003/2500kb,2520350,2,4857,4518,568035,572553
http://156.56.83.24:6003/2500kb,2520350,2,4857,3120,534286,537406
http://156.56.83.24:6003/2500kb,2520350,2,4857,6181,532153,538334
http://156.56.83.24:6003/2500kb,2520350,2,4857,3382,623559,626941
http://156.56.83.24:6003/2500kb,2520350,2,4857,1805,550481,552286
http://156.56.83.24:6003/2500kb,2520350,2,4857,4813,548981,553794
http://156.56.83.24:6003/2500kb,2520350,2,4857,4627,570864,575491
http://156.56.83.24:6003/2500kb,2520350,2,4857,5264,637931,643195
http://156.56.83.24:6003/2500kb,2520350,2,4857,5808,701046,706854
http://156.56.83.24:6003/2500kb,2520350,2,4857,4336,651065,655401
http://156.56.83.24:6003/2500kb,2520350,2,4857,4461,686417,690878
http://156.56.83.24:6003/2500kb,2520350,2,4857,4359,698060,702419
http://156.56.83.24:6003/2500kb,2520350,2,4857,4883,821402,826285
http://156.56.83.24:6003/2500kb,2520350,2,4857,2440,676027,678467
http://156.56.83.24:6003/2500kb,2520350,2,4857,5078,659559,664637
http://156.56.83.24:6003/2500kb,2520350,2,4857,3724,710815,714539
http://156.56.83.24:6003/2500kb,2520350,2,4857,3550,701251,704801
http://156.56.83.24:6003/2500kb,2520350,2,4857,5235,632481,637716
http://156.56.83.24:6003/2500kb,2520350,2,4857,4043,686040,690083
http://156.56.83.24:6003/2500kb,2520350,2,4857,1638,582744,584382
http://156.56.83.24:6003/2500kb,2520350,2,4857,4604,609880,614484
http://156.56.83.24:6003/2500kb,2520350,2,4857,4324,667341,671665
http://156.56.83.24:6003/2500kb,2520350,2,4857,4406,687918,692324
http://156.56.83.24:6003/2500kb,2520350,2,4857,3774,668008,671782
http://156.56.83.24:6003/2500kb,2520350,2,4857,4631,554599,559230
http://156.56.83.24:6003/2500kb,2520350,2,4857,1731,554939,556670
http://156.56.83.24:6003/2500kb,2520350,2,4857,2056,532741,534797
http://156.56.83.24:6003/2500kb,2520350,2,4857,3446,519324,522770
http://156.56.83.24:6003/2500kb,2520350,2,4857,1904,560127,562031
http://156.56.83.24:6003/2500kb,2520350,2,4857,3732,527603,531335
http://156.56.83.24:6003/2500kb,2520350,2,4857,2400,513541,515941
http://156.56.83.24:6003/2500kb,2520350,2,4857,2902,537679,540581
http://156.56.83.24:6003/2500kb,2520350,2,4857,4497,573828,578325
http://156.56.83.24:6003/2500kb,2520350,2,4857,4168,532153,536321
http://156.56.83.24:6003/2500kb,2520350,2,4857,4231,622378,626609
http://156.56.83.24:6003/2500kb,2520350,2,4857,2062,573715,575777
http://156.56.83.24:6003/2500kb,2520350,2,4857,4395,514048,518443
http://156.56.83.24:6003/2500kb,2520350,2,4857,2996,630152,633148
http://156.56.83.24:6003/2500kb,2520350,2,4857,5719,624358,630077
http://156.56.83.24:6003/2500kb,2520350,2,4857,2554,607633,610187
http://156.56.83.24:6003/2500kb,2520350,2,4857,3199,616726,619925
http://156.56.83.24:6003/2500kb,2520350,2,4857,5374,676005,681379
http://156.56.83.24:6003/2500kb,2520350,2,4857,4898,600649,605547
http://156.56.83.24:6003/2500kb,2520350,2,4857,3492,621857,625349
http://156.56.83.24:6003/2500kb,2520350,2,4857,3026,712061,715087
http://156.56.83.24:6003/2500kb,2520350,2,4857,2693,576885,579578
http://156.56.83.24:6003/2500kb,2520350,2,4857,5039,541279,546318
http://156.56.83.24:6003/2500kb,2520350,2,4857,4454,555162,559616
http://156.56.83.24:6003/2500kb,2520350,2,4857,3222,625725,628947
http://156.56.83.24:6003/2500kb,2520350,2,4857,3342,539392,542734
http://156.56.83.24:6003/2500kb,2520350,2,4857,2487,560448,562935
http://156.56.83.24:6003/2500kb,2520350,2,4857,5437,602442,607879
http://156.56.83.24:6003/2500kb,2520350,2,4857,4727,654050,658777
http://156.56.83.24:6003/2500kb,2520350,2,4857,6032,671642,677674
http://156.56.83.24:6003/2500kb,2520350,2,4857,5933,613486,619419
http://156.56.83.24:6003/2500kb,2520350,2,4857,4078,579638,583716
http://156.56.83.24:6003/2500kb,2520350,2,4857,2630,680142,682772
http://156.56.83.24:6003/2500kb,2520350,2,4857,4065,639875,643940
http://156.56.83.24:6003/2500kb,2520350,2,4857,4487,624690,629177
http://156.56.83.24:6003/2500kb,2520350,2,4857,4498,680391,684889
http://156.56.83.24:6003/2500kb,2520350,2,4857,5871,660957,666828
http://156.56.83.24:6003/2500kb,2520350,2,4857,3102,703236,706338
http://156.56.83.24:6003/2500kb,2520350,2,4857,3963,519386,523349
http://156.56.83.24:6003/2500kb,2520350,2,4857,4773,610169,614942
http://156.56.83.24:6003/2500kb,2520350,2,4857,5861,681373,687234
http://156.56.83.24:6003/2500kb,2520350,2,4857,3208,556567,559775
http://156.56.83.24:6003/2500kb,2520350,2,4857,3871,692140,696011
http://156.56.83.24:6003/2500kb,2520350,2,4857,5227,638502,643729
http://156.56.83.24:6003/2500kb,2520350,2,4857,3043,531367,534410
