url,dataLen,connId,timeForConnect,timeForRequest,timeForResponse,timeForRequestAndResponse
http://156.56.83.24:6003/2500kb,2520350,1,4896,2139,2113739,2115878
http://156.56.83.24:6003/2500kb,2520350,1,2333,2513,2112763,2115276
http://156.56.83.24:6003/2500kb,2520350,1,2521,2442,2117761,2120203
http://156.56.83.24:6003/2500kb,2520350,1,2186,2147,2114423,2116570
http://156.56.83.24:6003/2500kb,2520350,1,2551,1992,2114606,2116598
http://156.56.83.24:6003/2500kb,2520350,1,2211,2004,2113781,2115785
http://156.56.83.24:6003/2500kb,2520350,1,2188,2769,2112580,2115349
http://156.56.83.24:6003/2500kb,2520350,1,2330,2458,2112609,2115067
http://156.56.83.24:6003/2500kb,2520350,1,2116,2509,2112644,2115153
http://156.56.83.24:6003/2500kb,2520350,1,2146,2203,2113993,2116196
http://156.56.83.24:6003/2500kb,2520350,1,2231,2472,2113861,2116333
http://156.56.83.24:6003/2500kb,2520350,1,1893,2165,2112408,2114573
http://156.56.83.24:6003/2500kb,2520350,1,2371,2257,2113210,2115467
http://156.56.83.24:6003/2500kb,2520350,1,2047,1984,2113328,2115312
http://156.56.83.24:6003/2500kb,2520350,1,2093,2067,2112982,2115049
http://156.56.83.24:6003/2500kb,2520350,1,2545,3355,2112631,2115986
http://156.56.83.24:6003/2500kb,2520350,1,2003,2276,2114962,2117238
http://156.56.83.24:6003/2500kb,2520350,1,2651,4880,2112971,2117851
http://156.56.83.24:6003/2500kb,2520350,1,3416,2587,2116597,2119184
http://156.56.83.24:6003/2500kb,2520350,1,3581,2630,2115356,2117986
http://156.56.83.24:6003/2500kb,2520350,1,3006,2817,2115870,2118687
http://156.56.83.24:6003/2500kb,2520350,1,2546,5278,2111243,2116521
http://156.56.83.24:6003/2500kb,2520350,1,2985,2410,2114047,2116457
http://156.56.83.24:6003/2500kb,2520350,1,2073,2142,2113406,2115548
http://156.56.83.24:6003/2500kb,2520350,1,2902,3102,2114924,2118026
http://156.56.83.24:6003/2500kb,2520350,1,2525,2446,2113808,2116254
http://156.56.83.24:6003/2500kb,2520350,1,2870,2723,2113705,2116428
http://156.56.83.24:6003/2500kb,2520350,1,5155,2716,2113909,2116625
http://156.56.83.24:6003/2500kb,2520350,1,2480,1929,2114290,2116219
http://156.56.83.24:6003/2500kb,2520350,1,2021,2231,2112998,2115229
http://156.56.83.24:6003/2500kb,2520350,1,2411,3358,2112430,2115788
http://156.56.83.24:6003/2500kb,2520350,1,2227,2591,2115722,2118313
http://156.56.83.24:6003/2500kb,2520350,1,2178,2133,2114632,2116765
http://156.56.83.24:6003/2500kb,2520350,1,2213,2880,2113700,2116580
http://156.56.83.24:6003/2500kb,2520350,1,2190,2507,2114309,2116816
http://156.56.83.24:6003/2500kb,2520350,1,3306,9639,2110234,2119873
http://156.56.83.24:6003/2500kb,2520350,1,1841,2189,2114304,2116493
http://156.56.83.24:6003/2500kb,2520350,1,2486,3130,2114099,2117229
http://156.56.83.24:6003/2500kb,2520350,1,2080,2352,2114361,2116713
http://156.56.83.24:6003/2500kb,2520350,1,2305,2482,2118836,2121318
http://156.56.83.24:6003/2500kb,2520350,1,15191,13070,2109707,2122777
http://156.56.83.24:6003/2500kb,2520350,1,2244,2598,2114653,2117251
http://156.56.83.24:6003/2500kb,2520350,1,2140,2190,2115685,2117875
http://156.56.83.24:6003/2500kb,2520350,1,2146,2269,2113794,2116063
http://156.56.83.24:6003/2500kb,2520350,1,2814,3193,2113836,2117029
http://156.56.83.24:6003/2500kb,2520350,1,3462,2823,2112675,2115498
http://156.56.83.24:6003/2500kb,2520350,1,3008,3200,2113754,2116954
http://156.56.83.24:6003/2500kb,2520350,1,2252,2366,2114210,2116576
http://156.56.83.24:6003/2500kb,2520350,1,2411,2898,2112611,2115509
http://156.56.83.24:6003/2500kb,2520350,1,2310,3339,2113551,2116890
http://156.56.83.24:6003/2500kb,2520350,1,2201,2142,2114378,2116520
http://156.56.83.24:6003/2500kb,2520350,1,2862,2212,2113422,2115634
http://156.56.83.24:6003/2500kb,2520350,1,3330,3243,2113060,2116303
http://156.56.83.24:6003/2500kb,2520350,1,2451,2536,2114586,2117122
http://156.56.83.24:6003/2500kb,2520350,1,2187,2718,2114318,2117036
http://156.56.83.24:6003/2500kb,2520350,1,3296,2274,2113307,2115581
http://156.56.83.24:6003/2500kb,2520350,1,3705,2407,2113575,2115982
http://156.56.83.24:6003/2500kb,2520350,1,2765,2230,2114009,2116239
http://156.56.83.24:6003/2500kb,2520350,1,2488,2509,2113256,2115765
http://156.56.83.24:6003/2500kb,2520350,1,3390,5292,2112835,2118127
http://156.56.83.24:6003/2500kb,2520350,1,2168,2692,2113531,2116223
http://156.56.83.24:6003/2500kb,2520350,1,2765,2451,2113043,2115494
http://156.56.83.24:6003/2500kb,2520350,1,2737,4045,2111867,2115912
http://156.56.83.24:6003/2500kb,2520350,1,3234,2602,2114131,2116733
http://156.56.83.24:6003/2500kb,2520350,1,3337,2877,2112684,2115561
http://156.56.83.24:6003/2500kb,2520350,1,3212,2353,2113792,2116145
http://156.56.83.24:6003/2500kb,2520350,1,2265,2692,2113581,2116273
http://156.56.83.24:6003/2500kb,2520350,1,2556,3749,2112865,2116614
http://156.56.83.24:6003/2500kb,2520350,1,2154,2045,2114681,2116726
http://156.56.83.24:6003/2500kb,2520350,1,3115,2821,2114812,2117633
http://156.56.83.24:6003/2500kb,2520350,1,2985,3054,2112509,2115563
http://156.56.83.24:6003/2500kb,2520350,1,4698,2806,2115394,2118200
http://156.56.83.24:6003/2500kb,2520350,1,4239,2490,2114172,2116662
http://156.56.83.24:6003/2500kb,2520350,1,2707,2481,2113760,2116241
http://156.56.83.24:6003/2500kb,2520350,1,2192,2277,2113370,2115647
http://156.56.83.24:6003/2500kb,2520350,1,2762,2286,2114390,2116676
http://156.56.83.24:6003/2500kb,2520350,1,3232,1929,2113550,2115479
http://156.56.83.24:6003/2500kb,2520350,1,2140,2130,2114109,2116239
http://156.56.83.24:6003/2500kb,2520350,1,2416,2195,2114065,2116260
http://156.56.83.24:6003/2500kb,2520350,1,2961,3088,2113344,2116432
http://156.56.83.24:6003/2500kb,2520350,1,3735,2434,2114368,2116802
http://156.56.83.24:6003/2500kb,2520350,1,2412,4141,2113093,2117234
http://156.56.83.24:6003/2500kb,2520350,1,2049,2509,2113730,2116239
http://156.56.83.24:6003/2500kb,2520350,1,1883,2784,2112872,2115656
http://156.56.83.24:6003/2500kb,2520350,1,2017,2594,2112618,2115212
http://156.56.83.24:6003/2500kb,2520350,1,2986,2426,2112832,2115258
http://156.56.83.24:6003/2500kb,2520350,1,2104,4744,2111055,2115799
http://156.56.83.24:6003/2500kb,2520350,1,2095,2671,2114002,2116673
http://156.56.83.24:6003/2500kb,2520350,1,2401,2481,2114201,2116682
http://156.56.83.24:6003/2500kb,2520350,1,2158,2253,2114585,2116838
http://156.56.83.24:6003/2500kb,2520350,1,2399,2231,2113762,2115993
http://156.56.83.24:6003/2500kb,2520350,1,3125,4445,2110819,2115264
http://156.56.83.24:6003/2500kb,2520350,1,2375,2327,2113494,2115821
http://156.56.83.24:6003/2500kb,2520350,1,2232,3375,2114298,2117673
http://156.56.83.24:6003/2500kb,2520350,1,2568,2356,2113183,2115539
http://156.56.83.24:6003/2500kb,2520350,1,2582,2378,2115067,2117445
http://156.56.83.24:6003/2500kb,2520350,1,3163,3588,2111606,2115194
http://156.56.83.24:6003/2500kb,2520350,1,3513,4108,2112759,2116867
http://156.56.83.24:6003/2500kb,2520350,1,3592,3517,2111948,2115465
http://156.56.83.24:6003/2500kb,2520350,1,2503,3317,2112143,2115460
http://156.56.83.24:6003/2500kb,2520350,1,10338,3451,2112958,2116409
http://156.56.83.24:6003/2500kb,2520350,1,5981,4630,2114396,2119026
http://156.56.83.24:6003/2500kb,2520350,1,2773,3385,2111810,2115195
http://156.56.83.24:6003/2500kb,2520350,1,2982,3427,2113187,2116614
http://156.56.83.24:6003/2500kb,2520350,1,2837,3836,2112195,2116031
http://156.56.83.24:6003/2500kb,2520350,1,3217,2788,2113246,2116034
http://156.56.83.24:6003/2500kb,2520350,1,2687,2694,2114256,2116950
http://156.56.83.24:6003/2500kb,2520350,1,4972,2488,2113506,2115994
http://156.56.83.24:6003/2500kb,2520350,1,2785,2604,2112837,2115441
http://156.56.83.24:6003/2500kb,2520350,1,2150,2738,2114484,2117222
http://156.56.83.24:6003/2500kb,2520350,1,2181,2071,2115441,2117512
http://156.56.83.24:6003/2500kb,2520350,1,2636,2316,2113386,2115702
http://156.56.83.24:6003/2500kb,2520350,1,2072,2266,2113809,2116075
http://156.56.83.24:6003/2500kb,2520350,1,2422,3445,2113095,2116540
http://156.56.83.24:6003/2500kb,2520350,1,4332,2918,2114805,2117723
http://156.56.83.24:6003/2500kb,2520350,1,2691,3077,2115774,2118851
http://156.56.83.24:6003/2500kb,2520350,1,2078,2594,2113712,2116306
http://156.56.83.24:6003/2500kb,2520350,1,4450,2953,2113357,2116310
http://156.56.83.24:6003/2500kb,2520350,1,2019,2617,2113800,2116417
http://156.56.83.24:6003/2500kb,2520350,1,2824,1936,2113902,2115838
http://156.56.83.24:6003/2500kb,2520350,1,4188,4523,2113114,2117637
http://156.56.83.24:6003/2500kb,2520350,1,2896,2630,2114816,2117446
http://156.56.83.24:6003/2500kb,2520350,1,3270,3590,2113861,2117451
http://156.56.83.24:6003/2500kb,2520350,1,2270,3514,2114416,2117930
http://156.56.83.24:6003/2500kb,2520350,1,2815,2653,2112651,2115304
http://156.56.83.24:6003/2500kb,2520350,1,20622,2495,2113663,2116158
http://156.56.83.24:6003/2500kb,2520350,1,2987,2853,2113351,2116204
http://156.56.83.24:6003/2500kb,2520350,1,1871,2860,2112929,2115789
http://156.56.83.24:6003/2500kb,2520350,1,2655,3554,2112871,2116425
http://156.56.83.24:6003/2500kb,2520350,1,2434,2137,2112826,2114963
http://156.56.83.24:6003/2500kb,2520350,1,2799,3622,2113070,2116692
http://156.56.83.24:6003/2500kb,2520350,1,2813,2544,2130477,2133021
http://156.56.83.24:6003/2500kb,2520350,1,2244,2728,2114357,2117085
http://156.56.83.24:6003/2500kb,2520350,1,2359,2986,2114590,2117576
http://156.56.83.24:6003/2500kb,2520350,1,2511,2389,2114628,2117017
http://156.56.83.24:6003/2500kb,2520350,1,2816,2505,2114207,2116712
http://156.56.83.24:6003/2500kb,2520350,1,3203,4200,2113592,2117792
http://156.56.83.24:6003/2500kb,2520350,1,2491,2306,2115347,2117653
http://156.56.83.24:6003/2500kb,2520350,1,2079,1972,2112850,2114822
http://156.56.83.24:6003/2500kb,2520350,1,2405,2084,2115194,2117278
http://156.56.83.24:6003/2500kb,2520350,1,2170,2816,2114134,2116950
http://156.56.83.24:6003/2500kb,2520350,1,3442,2510,2115551,2118061
http://156.56.83.24:6003/2500kb,2520350,1,3112,2372,2113355,2115727
http://156.56.83.24:6003/2500kb,2520350,1,2903,2637,2114095,2116732
http://156.56.83.24:6003/2500kb,2520350,1,2811,3999,2114150,2118149
http://156.56.83.24:6003/2500kb,2520350,1,2316,2229,2113599,2115828
http://156.56.83.24:6003/2500kb,2520350,1,2300,2446,2115990,2118436
http://156.56.83.24:6003/2500kb,2520350,1,2045,2708,2112912,2115620
http://156.56.83.24:6003/2500kb,2520350,1,2167,2072,2113773,2115845
http://156.56.83.24:6003/2500kb,2520350,1,4393,2737,2114421,2117158
http://156.56.83.24:6003/2500kb,2520350,1,2058,2467,2113729,2116196
http://156.56.83.24:6003/2500kb,2520350,1,2836,2944,2112507,2115451
http://156.56.83.24:6003/2500kb,2520350,1,2538,2209,2112963,2115172
http://156.56.83.24:6003/2500kb,2520350,1,2069,2793,2112891,2115684
http://156.56.83.24:6003/2500kb,2520350,1,5640,5167,2111640,2116807
http://156.56.83.24:6003/2500kb,2520350,1,3128,3146,2114407,2117553
http://156.56.83.24:6003/2500kb,2520350,1,2203,2341,2116521,2118862
http://156.56.83.24:6003/2500kb,2520350,1,2570,3112,2112756,2115868
http://156.56.83.24:6003/2500kb,2520350,1,7545,2588,2113221,2115809
http://156.56.83.24:6003/2500kb,2520350,1,2621,2562,2114528,2117090
http://156.56.83.24:6003/2500kb,2520350,1,2387,2772,2114683,2117455
http://156.56.83.24:6003/2500kb,2520350,1,2995,2701,2114131,2116832
http://156.56.83.24:6003/2500kb,2520350,1,2161,2831,2113232,2116063
http://156.56.83.24:6003/2500kb,2520350,1,2424,2165,2116298,2118463
http://156.56.83.24:6003/2500kb,2520350,1,4421,2877,2113529,2116406
http://156.56.83.24:6003/2500kb,2520350,1,2616,3359,2113742,2117101
http://156.56.83.24:6003/2500kb,2520350,1,3593,2660,2113367,2116027
http://156.56.83.24:6003/2500kb,2520350,1,2509,2252,2113118,2115370
http://156.56.83.24:6003/2500kb,2520350,1,2951,2146,2113277,2115423
http://156.56.83.24:6003/2500kb,2520350,1,2270,2423,2124359,2126782
http://156.56.83.24:6003/2500kb,2520350,1,2409,2008,2113717,2115725
http://156.56.83.24:6003/2500kb,2520350,1,2197,2220,2116363,2118583
http://156.56.83.24:6003/2500kb,2520350,1,2686,2640,2112887,2115527
http://156.56.83.24:6003/2500kb,2520350,1,2808,3249,2114318,2117567
http://156.56.83.24:6003/2500kb,2520350,1,2988,3056,2113916,2116972
http://156.56.83.24:6003/2500kb,2520350,1,2754,2660,2113277,2115937
http://156.56.83.24:6003/2500kb,2520350,1,3273,2542,2114822,2117364
http://156.56.83.24:6003/2500kb,2520350,1,1923,2280,2114448,2116728
http://156.56.83.24:6003/2500kb,2520350,1,2416,2678,2117066,2119744
http://156.56.83.24:6003/2500kb,2520350,1,2122,2333,2112736,2115069
http://156.56.83.24:6003/2500kb,2520350,1,2839,2604,2114364,2116968
http://156.56.83.24:6003/2500kb,2520350,1,5633,2558,2112450,2115008
http://156.56.83.24:6003/2500kb,2520350,1,2673,4040,2112440,2116480
http://156.56.83.24:6003/2500kb,2520350,1,2576,3017,2111284,2114301
http://156.56.83.24:6003/2500kb,2520350,1,5651,2715,2113637,2116352
http://156.56.83.24:6003/2500kb,2520350,1,3105,2511,2112996,2115507
http://156.56.83.24:6003/2500kb,2520350,1,2162,2672,2113558,2116230
http://156.56.83.24:6003/2500kb,2520350,1,1823,2323,2113303,2115626
http://156.56.83.24:6003/2500kb,2520350,1,3155,2863,2112701,2115564
http://156.56.83.24:6003/2500kb,2520350,1,3507,2560,2113657,2116217
http://156.56.83.24:6003/2500kb,2520350,1,1975,2625,2113864,2116489
http://156.56.83.24:6003/2500kb,2520350,1,2136,2439,2114145,2116584
http://156.56.83.24:6003/2500kb,2520350,1,2819,4825,2110047,2114872
http://156.56.83.24:6003/2500kb,2520350,1,2117,3891,2113771,2117662
http://156.56.83.24:6003/2500kb,2520350,1,1999,2735,2113122,2115857
http://156.56.83.24:6003/2500kb,2520350,1,2267,4112,2111395,2115507
http://156.56.83.24:6003/2500kb,2520350,1,2211,3703,2114221,2117924
http://156.56.83.24:6003/2500kb,2520350,1,2364,2331,2113742,2116073
http://156.56.83.24:6003/2500kb,2520350,1,2682,2561,2133525,2136086
http://156.56.83.24:6003/2500kb,2520350,1,2286,2377,2114115,2116492
