url,dataLen,connId,timeForConnect,timeForRequest,timeForResponse,timeForRequestAndResponse
http://156.56.83.24:6003/250kb,260650,1,5147,2083,62191,64274
http://156.56.83.24:6003/250kb,260650,1,2619,2342,61774,64116
http://156.56.83.24:6003/250kb,260650,1,2102,2702,58915,61617
http://156.56.83.24:6003/250kb,260650,1,3190,3010,57512,60522
http://156.56.83.24:6003/250kb,260650,1,2206,1894,64629,66523
http://156.56.83.24:6003/250kb,260650,1,2772,2055,61866,63921
http://156.56.83.24:6003/250kb,260650,1,2717,2093,58149,60242
http://156.56.83.24:6003/250kb,260650,1,2459,2281,46143,48424
http://156.56.83.24:6003/250kb,260650,1,2893,2120,65143,67263
http://156.56.83.24:6003/250kb,260650,1,2337,2325,62902,65227
http://156.56.83.24:6003/250kb,260650,1,2989,2361,63570,65931
http://156.56.83.24:6003/250kb,260650,1,3828,2250,65069,67319
http://156.56.83.24:6003/250kb,260650,1,2709,2298,64661,66959
http://156.56.83.24:6003/250kb,260650,1,2784,1885,63015,64900
http://156.56.83.24:6003/250kb,260650,1,2451,2383,51819,54202
http://156.56.83.24:6003/250kb,260650,1,3301,2179,62049,64228
http://156.56.83.24:6003/250kb,260650,1,2138,2722,63425,66147
http://156.56.83.24:6003/250kb,260650,1,2178,2298,47229,49527
http://156.56.83.24:6003/250kb,260650,1,2947,2181,65350,67531
http://156.56.83.24:6003/250kb,260650,1,2282,2339,64307,66646
http://156.56.83.24:6003/250kb,260650,1,2624,2157,48774,50931
http://156.56.83.24:6003/250kb,260650,1,2459,3351,56993,60344
http://156.56.83.24:6003/250kb,260650,1,3742,2097,63697,65794
http://156.56.83.24:6003/250kb,260650,1,2801,2220,65938,68158
http://156.56.83.24:6003/250kb,260650,1,2267,1991,71556,73547
http://156.56.83.24:6003/250kb,260650,1,2868,2061,67743,69804
http://156.56.83.24:6003/250kb,260650,1,2175,1818,65467,67285
http://156.56.83.24:6003/250kb,260650,1,2373,2431,67108,69539
http://156.56.83.24:6003/250kb,260650,1,2411,1811,63654,65465
http://156.56.83.24:6003/250kb,260650,1,2326,2527,65296,67823
http://156.56.83.24:6003/250kb,260650,1,2239,2594,62611,65205
http://156.56.83.24:6003/250kb,260650,1,2488,1774,60185,61959
http://156.56.83.24:6003/250kb,260650,1,2527,2226,63262,65488
http://156.56.83.24:6003/250kb,260650,1,3001,2557,67389,69946
http://156.56.83.24:6003/250kb,260650,1,2368,2232,48034,50266
http://156.56.83.24:6003/250kb,260650,1,2589,2203,65799,68002
http://156.56.83.24:6003/250kb,260650,1,2554,2814,63225,66039
http://156.56.83.24:6003/250kb,260650,1,2118,2025,62467,64492
http://156.56.83.24:6003/250kb,260650,1,2415,2198,63971,66169
http://156.56.83.24:6003/250kb,260650,1,2423,2181,59694,61875
http://156.56.83.24:6003/250kb,260650,1,2156,2703,65476,68179
http://156.56.83.24:6003/250kb,260650,1,2307,2185,61888,64073
http://156.56.83.24:6003/250kb,260650,1,2496,3952,61608,65560
http://156.56.83.24:6003/250kb,260650,1,2949,1874,66175,68049
http://156.56.83.24:6003/250kb,260650,1,2391,2149,65748,67897
http://156.56.83.24:6003/250kb,260650,1,2156,2281,50321,52602
http://156.56.83.24:6003/250kb,260650,1,2361,2613,66792,69405
http://156.56.83.24:6003/250kb,260650,1,2208,2162,62062,64224
http://156.56.83.24:6003/250kb,260650,1,2866,2094,58126,60220
http://156.56.83.24:6003/250kb,260650,1,2422,2203,64494,66697
http://156.56.83.24:6003/250kb,260650,1,2735,3669,62743,66412
http://156.56.83.24:6003/250kb,260650,1,2347,1995,62301,64296
http://156.56.83.24:6003/250kb,260650,1,2250,2210,68910,71120
http://156.56.83.24:6003/250kb,260650,1,2613,1992,66149,68141
http://156.56.83.24:6003/250kb,260650,1,2522,2583,67650,70233
http://156.56.83.24:6003/250kb,260650,1,2851,2044,63378,65422
http://156.56.83.24:6003/250kb,260650,1,2510,1947,72556,74503
http://156.56.83.24:6003/250kb,260650,1,1969,1987,60550,62537
http://156.56.83.24:6003/250kb,260650,1,2294,1931,61171,63102
http://156.56.83.24:6003/250kb,260650,1,2128,2052,61879,63931
http://156.56.83.24:6003/250kb,260650,1,2213,2106,61697,63803
http://156.56.83.24:6003/250kb,260650,1,2449,1908,64569,66477
http://156.56.83.24:6003/250kb,260650,1,2221,2610,66533,69143
http://156.56.83.24:6003/250kb,260650,1,2529,2303,54849,57152
http://156.56.83.24:6003/250kb,260650,1,2263,1970,60129,62099
http://156.56.83.24:6003/250kb,260650,1,2542,3143,64443,67586
http://156.56.83.24:6003/250kb,260650,1,2481,2471,61095,63566
http://156.56.83.24:6003/250kb,260650,1,3349,2054,65924,67978
http://156.56.83.24:6003/250kb,260650,1,2371,1774,64991,66765
http://156.56.83.24:6003/250kb,260650,1,2227,2376,59140,61516
http://156.56.83.24:6003/250kb,260650,1,2654,2413,63919,66332
http://156.56.83.24:6003/250kb,260650,1,2298,2584,63981,66565
http://156.56.83.24:6003/250kb,260650,1,2301,2150,59415,61565
http://156.56.83.24:6003/250kb,260650,1,2350,2182,66555,68737
http://156.56.83.24:6003/250kb,260650,1,3276,2663,66569,69232
http://156.56.83.24:6003/250kb,260650,1,2196,2026,58306,60332
http://156.56.83.24:6003/250kb,260650,1,2812,2037,68339,70376
http://156.56.83.24:6003/250kb,260650,1,2637,2379,73226,75605
http://156.56.83.24:6003/250kb,260650,1,2260,2516,68427,70943
http://156.56.83.24:6003/250kb,260650,1,2391,1725,62229,63954
http://156.56.83.24:6003/250kb,260650,1,2586,2316,69133,71449
http://156.56.83.24:6003/250kb,260650,1,2124,2266,64590,66856
http://156.56.83.24:6003/250kb,260650,1,2237,2413,88560,90973
http://156.56.83.24:6003/250kb,260650,1,2209,2394,62743,65137
http://156.56.83.24:6003/250kb,260650,1,5584,2049,68843,70892
http://156.56.83.24:6003/250kb,260650,1,2631,2258,57797,60055
http://156.56.83.24:6003/250kb,260650,1,3200,2303,62054,64357
http://156.56.83.24:6003/250kb,260650,1,2328,2312,61965,64277
http://156.56.83.24:6003/250kb,260650,1,2137,2413,60440,62853
http://156.56.83.24:6003/250kb,260650,1,2308,2619,62991,65610
http://156.56.83.24:6003/250kb,260650,1,2331,2322,65857,68179
http://156.56.83.24:6003/250kb,260650,1,2329,2551,64588,67139
http://156.56.83.24:6003/250kb,260650,1,3698,2170,64912,67082
http://156.56.83.24:6003/250kb,260650,1,2690,2067,67195,69262
http://156.56.83.24:6003/250kb,260650,1,2652,2465,59849,62314
http://156.56.83.24:6003/250kb,260650,1,2232,2268,45562,47830
http://156.56.83.24:6003/250kb,260650,1,2266,1925,67294,69219
http://156.56.83.24:6003/250kb,260650,1,2369,2307,64135,66442
http://156.56.83.24:6003/250kb,260650,1,2171,2237,65197,67434
http://156.56.83.24:6003/250kb,260650,1,2304,2303,63908,66211
http://156.56.83.24:6003/250kb,260650,1,2146,1946,47088,49034
http://156.56.83.24:6003/250kb,260650,1,2415,2385,60057,62442
http://156.56.83.24:6003/250kb,260650,1,2633,2227,63778,66005
http://156.56.83.24:6003/250kb,260650,1,3090,2184,61536,63720
http://156.56.83.24:6003/250kb,260650,1,2274,2284,60308,62592
http://156.56.83.24:6003/250kb,260650,1,2383,2211,70898,73109
http://156.56.83.24:6003/250kb,260650,1,2478,2212,66618,68830
http://156.56.83.24:6003/250kb,260650,1,2091,2012,67040,69052
http://156.56.83.24:6003/250kb,260650,1,4151,2299,68426,70725
http://156.56.83.24:6003/250kb,260650,1,2325,2200,68609,70809
http://156.56.83.24:6003/250kb,260650,1,2555,2073,60313,62386
http://156.56.83.24:6003/250kb,260650,1,2120,2503,47822,50325
http://156.56.83.24:6003/250kb,260650,1,2551,2652,66315,68967
http://156.56.83.24:6003/250kb,260650,1,2427,2414,65573,67987
http://156.56.83.24:6003/250kb,260650,1,2465,2814,69116,71930
http://156.56.83.24:6003/250kb,260650,1,2092,2380,67519,69899
http://156.56.83.24:6003/250kb,260650,1,2654,2437,65565,68002
http://156.56.83.24:6003/250kb,260650,1,2042,1912,70882,72794
http://156.56.83.24:6003/250kb,260650,1,2834,2670,56387,59057
http://156.56.83.24:6003/250kb,260650,1,2805,2572,44676,47248
http://156.56.83.24:6003/250kb,260650,1,2256,2472,69906,72378
http://156.56.83.24:6003/250kb,260650,1,2461,3257,49293,52550
http://156.56.83.24:6003/250kb,260650,1,3508,2551,76251,78802
http://156.56.83.24:6003/250kb,260650,1,3034,2218,67628,69846
http://156.56.83.24:6003/250kb,260650,1,2927,3316,47418,50734
http://156.56.83.24:6003/250kb,260650,1,2915,3117,65216,68333
http://156.56.83.24:6003/250kb,260650,1,3148,3100,49849,52949
http://156.56.83.24:6003/250kb,260650,1,2760,2974,64146,67120
http://156.56.83.24:6003/250kb,260650,1,2306,2519,72012,74531
http://156.56.83.24:6003/250kb,260650,1,2105,2175,62482,64657
http://156.56.83.24:6003/250kb,260650,1,2109,2537,59370,61907
http://156.56.83.24:6003/250kb,260650,1,2480,2078,66029,68107
http://156.56.83.24:6003/250kb,260650,1,2166,2014,67470,69484
http://156.56.83.24:6003/250kb,260650,1,2121,2289,65807,68096
http://156.56.83.24:6003/250kb,260650,1,2092,1989,62612,64601
http://156.56.83.24:6003/250kb,260650,1,2346,2047,68778,70825
http://156.56.83.24:6003/250kb,260650,1,2225,2496,65121,67617
http://156.56.83.24:6003/250kb,260650,1,2951,1968,62102,64070
http://156.56.83.24:6003/250kb,260650,1,2228,2635,62568,65203
http://156.56.83.24:6003/250kb,260650,1,2347,1969,61519,63488
http://156.56.83.24:6003/250kb,260650,1,2502,2160,57549,59709
http://156.56.83.24:6003/250kb,260650,1,2362,1978,49998,51976
http://156.56.83.24:6003/250kb,260650,1,2129,2555,64072,66627
http://156.56.83.24:6003/250kb,260650,1,2134,2247,66690,68937
http://156.56.83.24:6003/250kb,260650,1,2312,2349,55617,57966
http://156.56.83.24:6003/250kb,260650,1,2169,2443,63036,65479
http://156.56.83.24:6003/250kb,260650,1,2346,2333,64895,67228
http://156.56.83.24:6003/250kb,260650,1,2106,2197,61191,63388
http://156.56.83.24:6003/250kb,260650,1,2263,1760,66535,68295
http://156.56.83.24:6003/250kb,260650,1,2220,2230,60572,62802
http://156.56.83.24:6003/250kb,260650,1,2266,2234,59057,61291
http://156.56.83.24:6003/250kb,260650,1,3024,2296,58643,60939
http://156.56.83.24:6003/250kb,260650,1,2941,2070,65648,67718
http://156.56.83.24:6003/250kb,260650,1,2426,2153,66974,69127
http://156.56.83.24:6003/250kb,260650,1,2246,1918,63754,65672
http://156.56.83.24:6003/250kb,260650,1,2218,2076,67516,69592
http://156.56.83.24:6003/250kb,260650,1,2566,2183,63748,65931
http://156.56.83.24:6003/250kb,260650,1,2327,2072,65597,67669
http://156.56.83.24:6003/250kb,260650,1,2353,2145,57600,59745
http://156.56.83.24:6003/250kb,260650,1,2355,2439,67278,69717
http://156.56.83.24:6003/250kb,260650,1,2357,2543,61146,63689
http://156.56.83.24:6003/250kb,260650,1,2025,2757,65917,68674
http://156.56.83.24:6003/250kb,260650,1,2269,2866,58767,61633
http://156.56.83.24:6003/250kb,260650,1,2633,2377,70717,73094
http://156.56.83.24:6003/250kb,260650,1,2489,4857,61655,66512
http://156.56.83.24:6003/250kb,260650,1,2232,2042,56056,58098
http://156.56.83.24:6003/250kb,260650,1,3273,2108,46430,48538
http://156.56.83.24:6003/250kb,260650,1,2389,1917,55506,57423
http://156.56.83.24:6003/250kb,260650,1,2638,2302,72597,74899
http://156.56.83.24:6003/250kb,260650,1,2230,2467,70648,73115
http://156.56.83.24:6003/250kb,260650,1,2520,3083,75548,78631
http://156.56.83.24:6003/250kb,260650,1,2243,1940,65795,67735
http://156.56.83.24:6003/250kb,260650,1,2369,2211,64530,66741
http://156.56.83.24:6003/250kb,260650,1,2108,2284,62379,64663
http://156.56.83.24:6003/250kb,260650,1,2361,2372,65047,67419
http://156.56.83.24:6003/250kb,260650,1,2291,2795,63108,65903
http://156.56.83.24:6003/250kb,260650,1,2179,2489,62558,65047
http://156.56.83.24:6003/250kb,260650,1,2391,2321,59541,61862
http://156.56.83.24:6003/250kb,260650,1,2038,2488,69142,71630
http://156.56.83.24:6003/250kb,260650,1,2164,1968,65683,67651
http://156.56.83.24:6003/250kb,260650,1,2522,2288,65549,67837
http://156.56.83.24:6003/250kb,260650,1,10871,2044,64741,66785
http://156.56.83.24:6003/250kb,260650,1,2393,3813,50716,54529
http://156.56.83.24:6003/250kb,260650,1,2646,2205,58563,60768
http://156.56.83.24:6003/250kb,260650,1,2636,2259,57574,59833
http://156.56.83.24:6003/250kb,260650,1,2231,1933,62869,64802
http://156.56.83.24:6003/250kb,260650,1,2347,1705,64819,66524
http://156.56.83.24:6003/250kb,260650,1,2389,2120,66945,69065
http://156.56.83.24:6003/250kb,260650,1,2272,2350,52359,54709
http://156.56.83.24:6003/250kb,260650,1,2418,2133,68388,70521
http://156.56.83.24:6003/250kb,260650,1,4594,2003,62260,64263
http://156.56.83.24:6003/250kb,260650,1,2308,1954,63460,65414
http://156.56.83.24:6003/250kb,260650,1,2882,2086,65334,67420
http://156.56.83.24:6003/250kb,260650,1,2325,4621,79846,84467
http://156.56.83.24:6003/250kb,260650,1,2316,2314,62176,64490
http://156.56.83.24:6003/250kb,260650,1,2415,2609,62748,65357
http://156.56.83.24:6003/250kb,260650,1,5180,3904,61616,65520
http://156.56.83.24:6003/250kb,260650,1,2234,2075,70310,72385
http://156.56.83.24:6003/250kb,260650,1,2643,1954,62517,64471
http://156.56.83.24:6003/250kb,260650,1,2077,1978,72309,74287
